#####
#.@ #
# $ #
#   #
# $ #
#.  #
#####
