#########
#       #
#   $   #
#     *##
#. @$..##
#   . *##
# $  $###
#     ###
#########
