#########
### .   #
#   $   #
#*. @$  #
#########
