########
#   .@ #
#$  $$ #
#.   . #
########
