#########
###    @#
##*   $ #
###   $ #
###. .$ #
###*  . #
#########
