#########
#    @  #
# $   $ #
#  . .* #
# * #####
#########
