#########
#    #  #
#   $ *@#
# ..  $ #
#########
