#######
####. #
### $ #
##.$  #
#*.$@ #
#     #
#######
