########
# .    #
#     $#
# $$$ .#
# . +  #
##     #
########
