#######
#     #
# * $ #
#     #
#   * #
# +   #
# $  .#
#######
