#######
#    @#
#$*  .#
#   $ #
#.    #
#######
