############
# #    .   #
#  *+   $  #
#          #
# $    $ $ #
#.. $.     #
############
