########
#.  $  #
#.$ .$ #
#   *  #
#      #
# $+   #
#      #
########
