#########
# . * .##
#@$  #*##
#   #####
# $   ###
# $   .##
#########
