###########
##   .   ##
#.  $  $ .#
# .$     ##
#$.   $@ ##
#     $ .##
###########
