########
#    ###
#   $ ##
# .*@  #
#    . #
#    . #
# $$ $ #
#     .#
########
