######
#   ##
#  . #
# $ .#
#    #
#@$  #
# $ .#
#  #*#
######
