#####
##*##
##*##
# . #
# @ #
#   #
# $ #
#   #
#####
