############
#        *##
# .  $    .#
#. $.      #
#  $  # $ ##
# @$  .   *#
#     #    #
############
