############
#       .#*#
# $   $   ##
# @ *      #
#  $       #
#  . * .   #
############
