########
##     #
#. $#  #
#$  $. #
# @.   #
########
