#####
#   #
#$$.#
#   #
#.$ #
# . #
# @ #
#   #
#####
