############
#   $  . ###
# *.$ $    #
# @    .   #
############
