#########
####. $@#
####  **#
####  ###
#####   #
####. $ #
#####$  #
##*#.   #
#########
