###########
# @  #.* ##
#  . #$  *#
#        ##
#  $ $   ##
#.       ##
# $ .#* ###
###########
