###########
# *    .###
# $$  $####
#@  .#.####
###########
