############
#   .+  $  #
#      $  .#
#   $ .  ###
#     $ .*##
#   .    ###
#  $$    #*#
#      $ .##
############
