##########
#.##     #
#   .    #
#$  $    #
#@* $ .  #
##########
