######
#    #
#. * #
#$   #
#  @ #
######
