#######
#     #
# $   #
# *   #
#@$.. #
#######
