#####
#   #
#.$@#
##* #
#####
