######
#.   #
#  $ #
#    #
# $. #
#@   #
#.$  #
######
