########
#    . #
#@$  $ #
#. . $ #
########
