############
####. # $ .#
###        #
#.. $ .   ##
#    $ $ @ #
#$    . $$ #
#    .$* . #
#          #
############
