########
#   #*##
#   #*##
# $@  .#
########
