############
# .   . ## #
#          #
#  $  $  $ #
#.$   $@ * #
#    ..    #
############
