######
#   @#
#  $ #
#    #
# .* #
######
