############
#        ###
#. $$* @ $ #
#    ..    #
#   #*##   #
############
