########
#..   ##
#  $  .#
#   $  #
#.$  $ #
#   @ .#
##  $  #
####  ##
########
