#########
#     . #
# $ $ $ #
#.*.#   #
#       #
#    .  #
# @   $ #
#.$     #
#########
