##########
#.$@ . ###
#   $  $.#
# $.     #
#        #
##########
