######
#  +.#
# $$ #
#    #
######
