######
#.   #
#$*  #
#    #
#@   #
#    #
# *  #
######
