############
#.   .$    #
#        $.#
#      $  *#
# $     $  #
#     .  $ #
#$     #.. #
# @  #*#.  #
############
