#########
### #.###
##@  $..#
##*     #
#*  $ $ #
#       #
#########
