#######
##. @ #
###$$$#
###   #
###.#.#
#*#####
#######
#######
