#########
#       #
# $   $ #
#   @.$ #
# .$.$  #
#.    . #
#########
