############
#         ##
#  $       #
#        $ #
# $   .  $*#
#.        +#
#      $*.*#
#     #.#*##
############
