##########
#      . #
#  $$$  $#
#  @. . .#
##########
