###########
#####.  $ #
##*#.@ $  #
####$ .   #
###     . #
##. $   $ #
##. $     #
###########
