######
#    #
#. $ #
#    #
#  $@#
#. $ #
#  . #
######
