##########
#        #
#   * $$ #
#    @   #
# .$  .$ #
#.#      #
##* .    #
##########
