#########
# $. ####
#@ .$   #
# *    $#
#      .#
#########
