#######
##   @#
#* *$$#
####. #
#####.#
#######
#######
