######
# .  #
# $  #
# $@ #
#  . #
######
