###########
##   #    #
#    .  .*#
#     $$**#
#       @ #
###########
