######
#    #
#.$ *#
#   @#
######
