#####
#.#.#
#$ $#
# @ #
#####
