##########
#        #
# *   .$$#
#@.$    .#
#       ##
#  $ .  *#
#        #
##########
