###########
#      ..##
# $   $ *.#
#         #
#@  $  $  #
# .$  . ###
###########
