#########
# $   .##
# .   ###
# $  #* #
#.    $@#
#########
