######
###@*#
#  $.#
#    #
#    #
######
