############
############
##. ###*####
#*$  ...#  #
# @$  $    #
#  $     # #
#     *$.$ #
##  .      #
############
