########
#@$  .##
#$*$$.##
# #.   #
#.###  #
#####  #
########
########
