###########
####*   .@#
# $.    $ #
#  $    . #
#       $ #
#.$ #   . #
###########
