#########
#      .#
# .@$   #
# $$  $ #
# .    .#
#########
