##########
#.  $   ##
#        #
#   * $  #
# $  *$  #
#    +   #
#.   .#*##
##    ####
##########
