#########
#.     ##
# $$    #
#       #
#. + $  #
# #.$   #
# # $ . #
# $.    #
#########
