#######
##    #
##   .#
#*@$$.#
#     #
#######
