######
# @  #
# *$ #
#    #
#.#  #
#    #
# $.##
######
