#######
#####*#
#######
#    .#
# $####
#  ##.#
#  *#$#
#.  $@#
#######
