############
#   + .$   #
#  $$*    .#
#     *    #
#         ##
############
