###########
#       . #
#.$$      #
#     $ $ #
#    $$@. #
#   .  $  #
#  .    ..#
###########
