#######
#.   .#
#     #
# $.  #
# $.  #
#     #
#*$$  #
#@    #
#######
