#######
# . * #
# $  @#
#  $  #
# $  .#
#  .  #
#######
