######
# .  #
# $* #
# @  #
######
