######
#    #
#$ $ #
#. .@#
######
