##########
#.$   $. #
#@$      #
# #*     #
#    .   #
##########
