#####
#   #
# $ #
# . #
# ###
#   #
#$$ #
#+. #
#####
