##########
###*     #
#  .  $ ##
#@$$  . ##
#     $ ##
#  .   . #
##########
