########
#      #
#. +$ .#
#  $ $ #
#      #
#   $$ #
#    ..#
#  #####
########
