#######
#@$ . #
#$$   #
#.    #
##  . #
#######
