########
#.+$   #
#  $  .#
#$ *   #
#      #
#      #
########
