#####
# @ #
# $ #
#   #
#   #
# .$#
# *.#
#####
