############
#@ .#      #
#    . $   #
# $ .  .   #
#       .$ #
# $   . $$.#
#   $$  $. #
#        . #
############
