#######
# @   #
# $$* #
#    .#
# .   #
#######
