#########
#  .    #
# $ $ . #
#       #
#   @$..#
#   $ * #
#      ##
#########
