############
######*###*#
#########*@#
########.$$#
##########.#
############
