#######
#######
#######
##*#  #
#### $#
###  .#
#### *#
#*#.$@#
#######
