#######
#     #
#  *  #
#  .  #
#. $  #
# $$. #
# @   #
# *   #
#######
