#########
#       #
#  $ @  #
#.$   * #
# *.##  #
#    .$ #
#       #
#. $    #
#########
