##########
#       ##
# $$  $  #
#  .  $  #
# .@.   .#
###$ #   #
###.##.$ #
##########
