#########
##*     #
#.$.  $ #
##    @ #
#########
