######
#  @ #
#$$$*#
#. # #
##.# #
####.#
######
######
######
