######
#    #
#.$ *#
#  . #
#@.  #
# $  #
# $  #
#    #
######
