#######
# ..  #
#@$ $ #
#     #
#######
