#####
#   #
#  @#
# $ #
#.  #
# * #
#####
