########
#  *   #
#   @ $#
#  $  .#
###   .#
########
