##########
##.     ##
# **$@$. #
#        #
##########
