#######
#@    #
# $.$.#
#     #
#  $  #
###.  #
#.$$. #
#     #
#######
