#######
#@*   #
# $   #
#  .  #
#######
