##########
#@       #
#.$ *  $ #
#*#  .  ##
##########
