############
# *###.  $ #
#   *##    #
# #   + $  #
# ## $.  * #
#          #
############
