#####
#   #
#  @#
# $ #
#  .#
# $.#
# *##
#####
