###########
#  .      #
#  $     $#
#    *  #.#
#   #  $  #
#     * $ #
# $.#  . .#
#@$    . ##
###########
