##########
#@$  .  ##
#*       #
#####    #
#*####.$ #
##########
