############
# *        #
# $    $.  #
#@*        #
#.$ .      #
############
