############
####.     ##
####       #
# .        #
# $.   $*$@#
# $   $.   #
# $  .##.  #
############
