###########
#     $.###
#   @ .####
# $ $ .#*##
#     #*###
###########
