##########
###.     #
#.  .$@$ #
##    $  #
#*       #
# .  $$  #
#   .    #
##########
