######
###*+#
#  $*#
#    #
#    #
#    #
#    #
######
