#####
#   #
# $.#
#.$ #
#@  #
#####
