########
#.     #
# $ .# #
# *    #
# $$  ##
# @ .  #
########
