#####
#. ##
#   #
#*$ #
# @ #
#####
