#####
#   #
# $*#
#  @#
#.  #
## ##
#####
