#######
##. $ #
###   #
###@$ #
###  .#
##* * #
#######
