############
#          #
#$.  $..   #
# $ @*  $  #
#.         #
############
