##########
###.    .#
###     $#
###$   $@#
#*#.    $#
#####   .#
#####  ###
#*####*###
##########
