######
#   .#
#$$  #
#.  @#
######
