##########
# .  .   #
#   $    #
#  $  $* #
#    .@ ##
##########
