##########
# .  .   #
#    $ *##
##$    $.#
#      @ #
##########
