########
# $ .  #
#   $  #
#  @$..#
########
