#####
#   #
#   #
# $@#
#.  #
# * #
#####
