########
#     ##
#$$   ##
#+* . ##
########
