#######
#*+$  #
# $   #
#    ##
###.###
#######
