##########
#.#. $ .##
# . .. ###
#  $ $ ###
#  $     #
# $ $    #
#   @    #
##########
