######
#  $.#
#   .#
# $  #
#@   #
######
