############
#       #*##
#.  ..   ###
# $$$  @ #*#
#         ##
############
