###########
##*#*######
#########.#
########*$#
#######.$@#
###########
