#####
#.  #
#$$.#
#   #
# $ #
#   #
##.@#
#####
