###########
#    .  $ #
# .     $ #
# $ .$  . #
## $.    *#
##     @  #
###########
