#########
#   .  .#
#   $ $ #
#     $ #
# *.  $ #
#       #
#       #
#   .#*@#
#########
