##########
#       .#
#   $ $$@#
#$.  .   #
#. $  .  #
#   ##   #
##########
