#########
#. .    #
#$$   . #
#    $ *#
#  @    #
#########
