#########
#.$     #
# @$ .  #
#   . $ #
#########
