#######
#     #
# $.$ #
#   .@#
# $ .##
#######
