######
#    #
#   *#
#   ##
# $  #
#.@$ #
#  .##
# ##*#
######
