############
##**####.###
########$  #
########   #
####*#### $#
########.$+#
############
