#######
# #   #
# *   #
#   $.#
#.. $ #
#   $@#
# . $ #
#     #
#######
