#######
#.    #
#   $ #
# *#  #
#  * @#
#######
