#####
# $.#
# $ #
#  .#
# @ #
#####
