########
#      #
#      #
#      #
# . *$ #
#  *  ##
# *@$.##
########
