######
#  ###
#@$ ##
# * .#
######
