############
#      .   #
#       $. #
#..     .$ #
#  $   .$@ #
#$         #
# $ $ *  $ #
#.    .    #
############
