#######
#@    #
#.$   #
#.$   #
#     #
# *.$ #
#     #
#######
