##########
#       *#
# $ .    #
#  ..   .#
#  $     #
# $  .$ .#
#    $ $ #
#      @ #
##########
