#######
#  . @#
# $ $ #
#  .  #
#######
