#######
#     #
#  $  #
#   $.#
#.  $ #
#   $ #
#.  * #
##  + #
#######
