############
#        #*#
# . $   .###
#    *    @#
##$        #
#    *$#   #
#   ##.##* #
############
