###########
#   @     #
# $ $     #
#.  .* .$ #
# $     $ #
#      ..##
###########
