############
#        . #
#..$ #$  . #
# $@$#.##$ #
#  $ ####  #
# .  ##  * #
#   ##     #
############
