#####
# @ #
# $*#
# . #
#####
