######
# .  #
#@ $$#
#   .#
#    #
######
