#####
#.#.#
#   #
#$$ #
#@  #
#####
