#####
#.*##
#  ##
# $+#
#   #
# $ #
#   #
#####
