###########
# $ .   ###
#@$     .##
# $ .# *###
###########
