############
# .$    ####
# $  .   .##
# .  $$$ ###
#     +  ###
############
