###########
#   $  .###
#. $  @. .#
#  $ $   $#
# .       #
###########
