######
#.  .#
#    #
#  $ #
# $$ #
#.@  #
######
