#######
#   # #
#     #
#.  $ #
#     #
#@. . #
# $*$*#
#     #
#######
