##########
#####*.$@#
########$#
######## #
#*#####. #
#####  $ #
###*##.$ #
########.#
##########
