###########
#####*    #
####      #
#.   .    #
## *  .   #
##  $$$*$ #
#.    @   #
###########
