##########
##.    $@#
#*# $  $*#
###      #
###  .   #
###  .   #
##########
