##########
# @ * .  #
# $      #
# . $ $ .#
#        #
##########
