#####
#   #
# $$#
# ..#
# $.#
#   #
#@ ##
#   #
#####
