########
#  .   #
#    @ #
#  $ $ #
#    *.#
########
