##########
#  .. .  #
# $ $.$$ #
#     @  #
##########
