########
##. $@ #
#*.$   #
###    #
## . $ #
##     #
########
