#####
# $.#
#   #
# $+#
#####
