########
# $.  .#
#@ $ $ #
# .    #
########
