######
#    #
# . $#
#  $+#
# $  #
#  . #
######
