############
##*##      #
##*      $ #
#.*.$    . #
# $ .      #
#$         #
#  @       #
############
