#######
#     #
# $   #
# $..@#
#     #
# $.$ #
#.    #
#######
