#######
#+$   #
#*$ $ #
#     #
# #.  #
#     #
#.#####
#######
