############
#   #     ##
#   #    ###
# .. $   ###
# $$ .  ####
#  $*   ##*#
# . @   ##*#
############
