########
#..#####
# $  ###
#    ###
#   ####
#$.$@**#
#      #
########
