############
##     $.###
##    . *###
#.$   $ $ @#
#        . #
############
