#######
#  .  #
# $ $ #
# @ . #
#######
