###########
# *. .   @#
#    #  $ #
# $   $$. #
# $ .    ##
#        .#
###########
