######
###  #
#### #
#*## #
#.   #
#    #
#$$ .#
#@$ .#
######
