######
#    #
#  $.#
## $ #
#    #
# #. #
#$   #
#+*  #
######
