############
####### @. #
####### $  #
####.$     #
#*#..$     #
##.$  $  * #
###        #
############
