##########
#   #.$ *#
#   $   *#
#     .@ #
##########
