########
#.$@.  #
# .$   #
#    $ #
#      #
########
