###########
#         #
# $ $     #
# $       #
#+**..    #
###########
