##########
###@     #
##.  $ $ #
#.#      #
#   .  $ #
# *  $ . #
#$    $  #
#.    .  #
##########
