############
#  @       #
#  *$ * $  #
####.   .  #
############
