######
#@$ .#
#$ $##
#   *#
#.# ##
###.##
######
######
######
