######
#  . #
#    #
#  $ #
# .$@#
######
