###########
##        #
#    $$.  #
#  @ .$   #
#     $####
# .  *.####
# $ .$ .###
###########
