###########
#         #
# . *    ##
#.$    .###
#$$  $ .###
# @  ##*###
###########
