#########
#       #
#  $ $ .#
#  .    #
#  .  $ #
#       #
#     $ #
# @.$.* #
#########
