############
#      $.*##
#    $ $  .#
#. @   ##  #
#     .   *#
# $      $ #
#       .  #
############
