######
##.$@#
#   *#
#   ##
#  ###
######
