##########
###      #
##    .$ #
##$ # @  #
##.* * $ #
###    . #
##########
