###########
#         #
# @  $. $$#
#.$      .#
#     $. .#
###########
