#########
#.#* .  #
#  $  . #
#  $  $ #
#     @ #
#########
