#######
# . $@#
#    $#
#  ## #
#  #*.#
#######
