########
#     ##
#. * .##
#    $##
#$  $ .#
#@   ###
########
