############
##         #
## .  $  $ #
#. $ ##. *@#
#####*#    #
############
