#####
#   #
#   #
# * #
#@$.#
#   #
#####
