######
#.   #
#    #
#    #
# $ .#
#$ $.#
#   @#
######
