##########
#@$.   $.#
#.$    * #
#        #
##########
