######
#   .#
#  $ #
#  $.#
# .  #
#   $#
#  #@#
# $.##
######
