########
#. $   #
#     .#
#   $  #
#*  .  #
#.  $@ #
#     $#
#      #
########
