############
##.     #* #
##$ #.#  * #
##    $   @#
####     $ #
##.$   .   #
############
