#########
#       #
# $    .#
###  .$ #
##.  $@*#
#########
