########
###   .#
#.*    #
##     #
##  $ $#
##.  $@#
########
