##########
#. @$ .* #
#  $     #
#    #*###
##########
