############
#.         #
#  $.  @$  #
#      $$ .#
# $  *  .. #
#  .. $ .  #
#$    $ #  #
#     #    #
############
