#######
# @  .#
# * $$#
#     #
# *.  #
#     #
# $   #
#.    #
#######
