##########
#.    .  #
#  $$  * #
#  @$.   #
##########
