############
#.$      ###
# ..  $. #.#
#@$ $     $#
#          #
############
