#####
#   #
# $@#
#   #
# *.#
#####
