##########
#.##.##@ #
#$     . #
# $. #   #
# .  $   #
# $      #
#  $   * #
##.    $ #
##########
