######
#  * #
#   .#
# $  #
# @  #
######
