########
# .    #
# *  $ #
# . @$ #
########
