#####
#.$@#
#  *#
#   #
### #
#####
