#####
#.$ #
# $@#
#.  #
#####
