######
#@$.##
#* ###
#  ###
# $ .#
#.   #
#  $ #
#    #
######
