#########
#.$.    #
##     .#
## $  $ #
##   @$ #
#  .$. .#
#     $ #
#       #
#########
