#######
#     #
#   $ #
#..$. #
##$   #
#    *#
#@   ##
# $.###
#######
