#####
#   #
# $$#
# @.#
# *.#
#   #
#   #
#   #
#####
