#######
##.$ .#
#     #
# $ * #
#@$   #
#.    #
#######
