########
#  .   #
# $ $ *#
#   @ .#
########
