############
###  @*  .##
#.#   $  ###
#  .  $ $ .#
#$      # ##
#      .$ ##
############
