############
#          #
#.$.$ $  @ #
#   . *    #
############
