##########
##.    $+#
##$ $  .*#
#        #
##########
