###########
#*## * .  #
#       $ #
##$   *$  #
#.        #
###.    @ #
#.    $ $ #
###.      #
###########
