#########
# $ .## #
#   ##  #
# . .#* #
#      @#
#  $$$ .#
#       #
#########
