############
#       ####
# .  .$ ####
# $.$$######
# .  $+#####
############
