#########
#  $. * #
#@      #
# ##*   #
# #     #
# $   .##
# $    .#
#########
