######
##.$@#
####*#
######
######
