#########
#       #
#.$ $  *#
#@   $ .#
#.  #  ##
# $ ##  #
##.##   #
#########
