##########
#####    #
##*.#  @ #
#   .  * #
##  $$   #
#*       #
##########
