##########
##       #
## *$ .$@#
#.  .  $ #
##########
