#########
#+      #
# . $.$$#
# * .   #
#       #
#  $    #
# $    .#
#       #
#########
