###########
#    .    #
#$$$ @$   #
#..      .#
###########
