##########
#######  #
##. $    #
##**@$.  #
##########
