##########
###*#*.$@#
####*#.$ #
######   #
######.$ #
#######  #
#######* #
##########
##########
