#####
#.$@#
###*#
#####
#####
