#####
#  .#
# $@#
#   #
# $.#
#   #
#####
