#####
#.$+#
#  $#
#   #
#   #
#####
