######
# .*@#
#  $$#
#   .#
#    #
######
####*#
######
######
