############
#.       . #
# * @$$  * #
#         ##
############
