######
# @  #
# *  #
#    #
#    #
# $$ #
# ..##
######
