###########
#      .$ #
#@$       #
# *  . .$ #
###########
