#######
# $ .##
# *  ##
#    ##
# $$ ##
# +   #
# #.  #
#######
