######
#.$  #
#  $ #
#    #
# $  #
# +. #
######
