############
# $      .##
#    $$  *##
#  @ ..  ###
############
