######
#. $@#
#  $ #
##.  #
######
