############
#.       @ #
#$$  $ *   #
#.         #
###  #.    #
###..$ $ $.#
####       #
############
