#######
#@$  .#
#$$. ##
#.##  #
####  #
#######
