########
########
#@$..#.#
#     $#
#      #
#      #
#  $ $*#
# .    #
########
