###########
#   .    @#
#* $  .$  #
#     .$  #
###########
