############
#@     . . #
# $.$$ $   #
# .        #
############
