#####
# @ #
# $ #
#   #
#.  #
#.$ #
##* #
#####
