#######
#     #
# . $ #
# #   #
#  .* #
# *.  #
#  $$@#
#     #
#######
