########
#.$@$ .#
#      #
# $  . #
#      #
# .$ $ #
#     .#
########
