#########
# *     #
#.$     #
# *#  $ #
# @  .$ #
# #     #
# # ..$ #
####    #
#########
