############
##.  . ##*##
#  .$  #####
#*$@ $     #
#          #
############
