###########
#@        #
##*#* $   #
#.  $ .   #
###########
