######
#    #
#    #
#@$$ #
#$ . #
#..  #
######
