#######
#.    #
# $   #
#     #
##*@*##
#######
