###########
#      @  #
#.  $ . **#
#       * #
#   . $ $ #
#   $     #
#         #
#     * . #
###########
