########
# .$@  #
#    . #
# *  $ #
#      #
# .$   #
####  ##
#*######
########
