#########
#*.   $@#
#### #* #
###     #
##      #
#.$ *   #
#       #
#########
