#######
#     #
#@$ . #
# $. .#
# $ $ #
# .   #
#######
