#######
# .   #
# $#$ #
#  @ .#
# $ .##
#######
