#####
# *.#
#@$##
#   #
#####
