############
#   #   @  #
#      .$  #
# .$  .  $ #
# $ .$ . $ #
#          #
#   #. . $ #
############
