######
# @  #
# $$*#
#.   #
#    #
#    #
# .  #
######
