############
#   .      #
#       $  #
# $  .#  ###
# $ $ * .###
#@*.    ####
############
