########
#    * #
#  $+  #
#    .##
#$   $ #
#. #   #
########
