######
#  . #
#    #
#.$  #
# *  #
#    #
# @$ #
# *  #
######
