#####
#.$ #
##  #
#@* #
#   #
#####
