######
# + ##
# $$.#
#    #
######
