########
#    . #
#   $  #
# $#  $#
#   .@ #
# $.$ .#
#   . ##
########
