############
# ..  $    #
# $   $ ** #
#  ## #   @#
#     . $  #
#        . #
# $ * ##   #
# .   #*   #
############
