############
# .  @  ####
# $ *   ####
#       #*##
#  $ .# #*##
############
