############
#  +    #  #
#    $    *#
# $  .     #
# $  . . $ #
############
