########
#     .#
#  .   #
#   *  #
#@ $$ $#
#.     #
########
