###########
#      ####
#   $  ..##
#   .    ##
#   $ *$**#
#    @    #
###########
