######
#    #
# .  #
#  $$#
# $  #
#@ ..#
######
