######
#    #
#@$.*#
#   ##
#  ###
######
