###########
#@$.      #
#$ $ .### #
#.#*#######
###########
