########
# @    #
#     .#
# .$.$$#
#      #
########
