###########
#        .#
#  $$** $.#
# .@     .#
#  $     ##
#         #
###########
