########
#      #
#      #
# .*   #
#     .#
#  $** #
#    $@#
#      #
########
