######
#    #
#    #
# .$ #
#@*  #
######
