#######
#  @  #
#  $* #
#  .  #
#######
