#########
#.*# ..##
#  $ $ ##
#    @ ##
# $$    #
#.      #
#       #
#########
