#########
#.     .#
#  *  $ #
#    $  #
#  . $$ #
#  @  . #
#########
