#####
#   #
# .*#
# $ #
# @ #
#####
