##########
#   .  .##
#      ###
# $* $####
# @   ##*#
##########
