##########
#  . .   #
#  $     #
##* $  $+#
##     $ #
##.      #
##########
