###########
#         #
# $  $.*###
#+$  .  ###
###########
