######
##.$ #
#  . #
#    #
#.$$ #
#  @ #
######
