############
#  .     ###
# $$$ . .$ #
#   .@     #
###.   $   #
####     $.#
############
