#########
#    ####
# *$  #*#
# .@ ####
#########
