######
#    #
#  $ #
# $. #
#@.  #
# $ .#
######
