#####
#@  #
#$*$#
#.#.#
#####
#####
#####
#####
