#########
#@*     #
#$$     #
# $     #
#.$.    #
#.   .  #
##    * #
####    #
#########
