###########
##     ##.#
#  #.$    #
#   .     #
#  $      #
#$ @*.* $$#
#.#       #
###########
