##########
#       ##
#   .    #
#  $ *  ##
#      $.#
#  .$$  ##
# * . @ ##
##########
