#####
# @.#
# $ #
#   #
#   #
# $ #
# . #
# $.#
#####
