###########
#*###.##  #
#.##*     #
#  $@$    #
#$# * .   #
#         #
###########
