###########
#   .*   @#
#. $      #
#$  * .$  #
#         #
###########
