######
#   .#
#  $ #
# @. #
#  $ #
#  * #
# .$ #
#    #
######
