#######
#   #.#
# $   #
#* + $#
#     #
#######
