##########
#@    .#.#
#  $.    #
# $    *$#
#        #
#       *#
##########
