###########
#    .###*#
#@$########
# $ .#*####
###########
