###########
#####.  $+#
#*#### $ $#
##*###  $ #
#####.    #
#########.#
###########
