#########
#.      #
# $ $.* #
#      @#
#########
