######
#   .#
#    #
#   .#
#    #
#  *.#
# $$$#
# @  #
######
