#######
#    .#
#@$ $ #
#.    #
#######
