#######
##. $@#
### $.#
##. $ #
#     #
#######
