#######
#     #
#$    #
#+$.  #
#######
