#########
##     .#
#. $@$ $#
##     .#
#########
