#########
#       #
# $ $ $ #
# @   #.#
#.  ..* #
##   $  #
####  ###
#########
