############
#  .   @   #
#$ $ $*    #
#..        #
############
