########
#   @  #
# $$   #
#   . *#
#   .  #
########
