######
#@$.##
#$*###
# ####
#.*###
######
######
######
######
