#######
#.   *#
#     #
#.@ $ #
#$*   #
#     #
#######
