#########
#     ###
#@  $ *##
#     ###
# $. .###
#    *#*#
#      ##
#########
