##########
#    #####
#  *$    #
# $ .#  .#
# $    $ #
#.*.#    #
# @      #
##########
