#####
#   #
# $ #
# *.#
# #@#
# * #
#   #
#####
