########
# @    #
# $ $. #
#  .$ .#
#     .#
#   $$.#
#      #
########
