#######
#.   .#
# $  $#
#    @#
#######
