#########
#   .  +#
# $   $ #
#      .#
# $   $ #
#.    $ #
## .    #
#########
