#####
#.# #
#  +#
#$$ #
#   #
#####
