############
# .      . #
# $    $$ @#
# $.    .  #
############
