######
#### #
##   #
#.$  #
#    #
#   *#
#  $+#
######
