#########
##   .  #
#     $ #
#* $@  .#
#########
