#####
# * #
# $+#
#   #
#####
