########
#  $.$+#
#  .   #
#    $ #
# $.   #
#      #
########
