##########
#  @     #
# $ $    #
#.$  . *.#
##########
