###########
#@.$   . .#
# $   . $ #
# $       #
#   .*    #
#$      $ #
#.    $   #
##       .#
###########
