#####
#.$ #
#   #
#   #
#@$ #
#  .#
#####
