#####
#  .#
#   #
#  .#
# $$#
# @ #
#####
