#########
##.$ ##.#
#.$  #  #
#.$#    #
# *    $#
#       #
# $    .#
# @    ##
#########
