#######
# $ . #
# *   #
#     #
# * $ #
#@   .#
#######
