######
#    #
#.. ##
#  $ #
# $$ #
# +  #
######
