#########
###     #
###  $ .#
#       #
#$.$ .$ #
#+    $.#
#########
