############
##*#       #
#####      #
##  $   $. #
## .*      #
#  $+$.    #
# . $      #
############
