##########
#     ####
#     .###
# $ $.*###
#  @$ .###
##########
