###########
# .  .   @#
#   $ * . #
## $  $ $ #
#     $   #
#   .     #
#      $. #
#    .. $ #
###########
