######
#@ .##
#.$$ #
#    #
######
