#####
#   #
# @ #
##$ #
#.$.#
#####
