#########
#       #
#  *  . #
#       #
#     @ #
#     $ #
# $  $ .#
# *. $ .#
#########
