##########
#     *. #
# # $ $@##
# #    $ #
#  .    .#
##########
