#####
#####
##* #
#.# #
#   #
#*$ #
#  @#
#####
