########
##     #
#.$ $  #
#. .$  #
###   @#
########
