########
#@$ .###
#*# $.##
###  ###
########
