##########
#@       #
# . *   $#
#  $ .  .#
#    *$  #
#        #
##########
