###########
#.@    . .#
# $       #
#*$   # $$#
#     .   #
###########
