###########
### $..$  #
##*  #    #
###  $    #
### .$    #
####*.@   #
###########
