###########
#@$  .#####
#     #####
# $.   .*##
# $ $   ###
###.# $  .#
###########
