###########
# .  $    #
##.$      #
### ..$ $*#
### @     #
###########
