#########
#####   #
#*#*# $ #
####.  @#
#########
