############
#@$    .   #
#*###  $ $ #
#*.$    .  #
###        #
#### $     #
##* .$ #.  #
###.       #
############
