######
#    #
#    #
#.$$.#
# @  #
######
