######
#    #
# $  #
#.   #
# $  #
#    #
#@*. #
######
