##########
#.       #
#.$  +   #
#    $ $ #
###      #
##*   $ .#
#####. $ #
##########
