######
##  ##
##   #
###  #
##   #
#*.$*#
###@ #
######
