######
#  . #
#  $ #
#  $@#
#    #
# $. #
##.###
#*####
######
