############
# $@$..#####
# $$  .###*#
#     $$.###
# .      ###
#  .  $  ###
#     .    #
#    .$    #
############
