############
##  @      #
#* $ $ .$  #
#      ..  #
############
