#######
#     #
#.  $ #
# *   #
#  .  #
# $.$ #
#   @ #
#######
