##########
#        #
# $     $#
#@       #
#  .*$  .#
# $    ###
# . .$ .##
##########
