#####
#   #
# $ #
# $ #
#. +#
# $ #
#   #
#  .#
#####
