############
#   . ######
# $. .    ##
# .       *#
# $.$ #   ##
#  *$$   ###
#      @   #
############
