########
###*#  #
####   #
#.     #
#..    #
#$$ $  #
#@*    #
########
