###########
#####.    #
#*  $   * #
#@$ .#    #
###########
