###########
#    .  $ #
#    $    #
#  @.  $ *#
#  .*     #
###########
