########
#   .  #
#      #
# $    #
#.*  $ #
#  .  @#
#$    *#
#      #
########
