##########
#   @    #
#   .$$* #
#  $     #
#      . #
# .    **#
#        #
##########
