############
#  #      ##
#  .  @. $##
# *  $   .*#
#  .$   $###
#        ###
############
