########
#    * #
#   .$@#
# *#####
########
