########
#    . #
## $.  #
#    $ #
#     @#
# $..$ #
########
