##########
##########
#.#####*##
#$$.######
#@$ .#####
##########
