######
#  + #
#  $ #
# .$ #
# $. #
#    #
######
