########
## .   #
# * $  #
#      #
# $  * #
# .   @#
########
