########
# $  ..#
#@  $ .#
#    $ #
# $.$  #
# .    #
#      #
#      #
########
