##########
#.       #
#  * $ $ #
#   .    #
#   #+ ###
#  $$ *###
##.    ###
##########
