###################
#####        ######
#     #   $  #@ ###
# #######$####  ###
# #    ## #  #$ ..#
# # $     #  #  #.#
# # $  #     #$ ..#
# #  ### ##     #.#
# ###  #  #  #$ ..#
# #    #  ####  #.#
# #$   $  $  #$ ..#
#    $ # $ $ #  #.#
#### $###    #$ ..#
####    $$ ###....#
####      #########
###################
