###################
#    #######  #####
#   $#  #  $  #   #
#  $  $  $ # $ $  #
##$ $   # @# $    #
#  $ ########### ##
# #   #.......# $##
# ##  # ......#  ##
# #   $........$ ##
# # $ #.... ..#  ##
#  $ $####$#### $##
# $   ### $   $  ##
# $     $ $  $    #
## ###### $ ##### #
#         #       #
###################
