###################
#  ################
#  #   ..#......###
#  # # ##### ...###
##$#    ........###
#   ##$######  ####
# $ #     ######@ #
##$ # $   ######  #
#  $ #$$$##       #
#      #    #$#$###
# #### #$$$$$    ##
# #    $     #   ##
# #   ##        ###
# ######$###### $ #
#        ######   #
###################
