###################
#   #    # ###....#
#   $$#   @  .....#
#   # ###   # ....#
## ## ###  #  ....#
## $ $     # # ####
##  $ $##  #      #
#### #  #### # ## #
#  # #$   ## #    #
# $  $  # ## #   ##
# # $ $    # #   ##
#  $ ## ## # ######
# $$     $$  ######
## ## ### $  ######
##    ###    ######
###################
