#################
#........########
#...#### #  #####
#...#  ###    $ #
#...$$     $ $  #
#  .#  $ $# $  ##
#...# #$#   $  ##
#.# # $   $    ##
#.  #$###$####$##
##  #   $ $    ##
##  #  $@$  #  ##
##  # #### $  $##
##  #    ###   ##
##  # $$ ########
##  #    ########
#################
