####################
##   $       ...#.##
##       ####..... #
## #######  #..... #
## #    $ $ ##....##
## #  $ # # ###...##
## # $@$ $  ##### ##
## #  $  $ $$   $ ##
#  #$# $#   # $## ##
# ##    ## ## $ # ##
# # $# $ $  #     ##
# #         ########
# ########$##   ####
#        #  $   ####
########    ########
##########  ########
####################
