###################
##               ##
###  $ $.$.$ $  ###
####  $.$.$.$  ####
##### .$.$.$. #####
###### .$.$. ######
####### .$. #######
######## . ########
#########@#########
######## . ########
####### .$. #######
###### .$.$. ######
##### .$.$.$. #####
####  $.$.$.$  ####
###  $ $.$.$ $  ###
##               ##
###################
