#####################
#############   #####
###     ##### # #####
###      #  #   #####
####.##  #    $######
###...#  #$###  $ ###
##  #.*.##  ##$   $ #
##$##.*.    #   $ $ #
##  #... ####$  #$  #
##$ #####.    $# $  #
##  ## $ .$ # $    ##
##$....#@ #.###   ###
##  #..##*$   #######
## #..*.   #  #######
## #  .*  ## ########
##  ##.###   ########
##$$# .# $$  ########
# $  $ $ $  #########
#     #     #########
#####################
