###################
##  #  ####  ###  #
## $$  #### $ $   #
##  #$ #  # $  $  #
### #@    #   ## ##
### #$ #$ #   $  ##
### #  # ## $ #  ##
### #### ####$#####
##   $ # #     ####
##  # .* ..$#  ####
### # .  $. # #####
# .* ##   ##  * ###
# ..* ##### $.. ###
##...$     ..*. ###
##  .###### ## ####
###########    ####
###################
