################
#####  #########
####   $  #   ##
###   $ .  .  ##
### # $ *#$#$###
# $ ####  ... ##
# # #   #$##  ##
# #.# *   #  ###
# .* # * *  #  #
##$ .#$.$.#.@  #
#  #. .$. #$** #
#  *.###  # . ##
# $$ $ #### . ##
##   #    #*$$##
###    ##     ##
################
