###################
#      #          #
# $ $    @$ $ $ $ #
###$#  $#.#$  #$###
###  #  #.#  #  ###
####  ###.###  ####
#####  ##.##  #####
######.. . ..######
######..$.$..######
#####  ##.##  #####
####  ###.###  ####
###  #  #.#  #  ###
###$#  $#.#$  #$###
# $ $    ..   $ $ #
#      #   #      #
###################
