###############
###########  ##
#   #   # $  ##
#  $   $ $ $ ##
##$ #*## ## ###
## $#.*.*.*  ##
###  ..*..#  ##
## $#*+*.*#$ ##
##  #..*..  ###
##  *.*.*.#$ ##
### ## ##*# $##
## $ $ $   $  #
##  $ #   #   #
##  ###########
###############
