###################
###  ##############
###$ #   ##########
## $   $  $ ###   #
# $   #*#   ## $  #
#   ###+###    # ##
## # ......# $ $ ##
## # *****.. # $  #
##  #*.*.*## $ $  #
#  $#..*..#### #  #
#     ###  ###  ###
### $   $$      ###
#########  ########
###################
