#################
#     #   #     #
# .$.$. .  $.$. #
## *#$## ##$#. ##
##      $.#  $ ##
### ###*.*# # ###
##  #.* $ * #  ##
## * $.$@$.$ * ##
##  # * $ *.#  ##
### # #*.*### ###
## $  #.$      ##
## .#$## ##$#* ##
# .$.$  . .$.$. #
#     #   #     #
#################
