######################
#  ###################
#  ################  #
#         ###  ##  $ #
##.###### ...     #. #
##.#      # .#   # $ #
##$$$$#$$$ #.#   ##. #
##.# $   $ #..      ##
##.#  $  $   # #   ###
##  #   $$ #   #######
##.  ##$  ############
##.   #  $.  #########
##. @ ###.#$ #########
#     ###    #########
#    #################
######################
