#####################
########    #########
######## $ $  #######
####   #.#    #######
#  $ #$#.##$#########
# $$. .#.$      #####
#  $.#.#.#####  #####
##  ....... @#     ##
#####$ #.### #$###$##
#### $  .  #  $ $ $ #
#### $ ###          #
####   ##############
#####################
