##########################
############# ..##########
############# ......#  ###
#############.. ##$$  $###
##############.##   $  ###
##########  ....# $  $$###
##########  .. .#$  $  ###
#   ###### ##.###  $$ $###
#   ###### ## #  $  #    #
# @   #### #  # # ###$ # #
#             #  $    $  #
#   ####      ### ####$$##
#  ########     #       ##
#  #########    ######  ##
#############     ### $ ##
##############    ###   ##
##########################
