##########################
##   #####################
## # #####################
#    ##  #################
# #     $      ###########
#   #### $  $$ #  ########
######## $$$ $ #$ ########
######## $  $ $ $ ########
########$   #$ $  $    ###
###### $ $$      ### @ ###
######  $ $$$$####...   ##
######  $     $ #. .#...##
######## $$$$   ......  ##
########      ##..#.....##
############# ##.....#####
#############   .....#####
##########################
