##########################
#######################  #
###@ ###########      #  #
#     ########## ### $ $ #
# ....##########   #  #..#
# . #  ## $   $ $# #  #..#
### #     $  $$$ # # $ $ #
### ...# $  $$   # #  #  #
###  ..# $   $ $ # # ##  #
####...#  $ $$ $ #$# #####
####   ## $  $ $   # #####
###### ######  ### # #####
#### .   ## #### .   . ###
####   . ####### #.#.# ###
###  .   #######   #   ###
### . ####################
###  #####################
##########################
