#############################
###   #########       #######
### #$######### # # # #######
# $. .  ###    . . . .    ###
# # # #$### # # # # # # #$###
#  . . . .  $ $ $ $  . .  ###
###$# # #$###########$# #$###
###  . .  ##        #  .  ###
#####$# #$####### # #$# #$###
#####  . .$ $ $ #   #  . .  #
#####$# # # # # #####$# # # #
#####  . . . . .  $  . . .  #
####### # # # # # # # # # # #
####### $ $. . .$ $ $ $ $ $ #
########### # # #############
###########  @  #############
#############################
