#####################
####   ##############
#### $$#   ##########
####.  . $ #    #####
##  .##.####### #####
## $.  . #    # #####
##.##$$$$#$$$ #######
##...    .    #    ##
##..##.####.### ##@##
### # $ $ $ # $ $  ##
### #       #     ###
### #.##.#.######  ##
###  $ # $.     $  ##
###    ###.## ###$###
##########        ###
#####################
