##############################
#######  ###            .$   #
###  $.       #####$####   # #
#    $.  #### #     .   ### .#
#  $ $.### ## # #### #  $.# $#
###  $.## # # # #  #  # $ #  #
######## # ## #$ $ ##   #. # #
############# #.#.  #  ### # #
#########   # ### ###   #    #
###*#####     .#  #   #$$*  ##
##*####### ## ## ## #  .#. ###
####*###  .$ .# $.$.## ### ###
###*#### #.####     # $.   ###
##*##### $$   ### ###   ##  ##
####*### #   . $@$  #######. #
######## ### ####.#        $ #
########     ##############  #
##############################
