##############################
####  ########################
###    .......... ############
##    #  ####$### ############
#      # #      #  ###########
#     #  # $$$  # # ##########
#####  # . .# ### . . . ######
#####   $. .#  # $$ $ $ @#####
########## ### #   ###########
#### $   $   # ## ############
####    $  $ #  # ## #########
#### $### ####  # # # ##  ####
####  $ $$$  # ## #  ##      #
#####        # ## #### $$$   #
###### ####### .....     #####
#####  $         ######  #####
#####   ######  ##############
##############################
