########################
##       #   ###########
#  $ $$$$$     #########
### $   $  ### #########
### $ $ $### # #########
####   $ ##  # #########
#######   ####   #######
########       # #######
#######   ####     #####
####@ $   ###  #.# #####
#### $ $ ####  ....    #
#### $$ ########.....  #
#### $  #######..#.##  #
### $ $ #######......  #
###  $ $ ###### . ..# ##
####  $  ####### ##.# ##
####    ########      ##
########################
