########################
######     #############
#  ### $$$ #############
#  ....$  ##############
#  ..# $  #  @##########
###$##$#### # ##########
##.*....$  $  ###  #####
## ..#####  ##   $ $   #
##....*.... #  $$  # $ #
########### #$$ ## #   #
##### $.###        $  ##
#####       $###$# #  ##
#########   $    $ #####
############    ########
########################
