######################
#       ##############
#   $   ######    ####
# #$#$ $ $  # $     ##
# $   $@$  $ $ $ $$ ##
# $ $# $ #     $$$  ##
#  $ $ #######   #####
##    ###....##### ..#
####$$# $$$$ #...* ..#
###         ##   #.. #
###  #  #$###....##*##
###   ##..$. ....    #
##### .*   .#....#   #
######################
