###########################
## # # # # # # # # # # # ##
#   .$    . $.  . $   .$  #
## $# #$# # # #$# # # #  ##
#  .  .    $.  .  .$ .  . #
## #$# # # # #$#$ $# #$# ##
# .     .$ .$    . $.  .  #
## $# # # # #@# # # # #$ ##
#  .  .$ .    $. $.     . #
## #$# #$ $#$# # # # #$# ##
# .  . $.  .  .$    .  .  #
##  # # # #$# # # #$# #$ ##
#  $.   $ .  .$ .    $.   #
## # # # # # # # # # # # ##
###########################
