###########################
###   #####################
### $$#   #################
###   . $ #   #############
#### ##   . $ #   #########
##   ##.### ....$ #   #####
## $$#   ###.##.  # $ #   #
##   # $ #  .##.###   .$$ #
### ##   .$$$#   ###.##   #
#   ##.###   #$$$.   ## ###
# $$.   ###.##.  # $ #   ##
#   # $ #  .##.###   #$$ ##
#####   # $.... ###.##   ##
#########   # $ .   ## ####
#############   # $ .   ###
#################   #$$ ###
#####################  @###
###########################
