###########################
#################   #######
###########       #.###   #
######      # ### #.    * #
#####  ###### ##  #  ### ##
##### ## $ ..$ # $   ##  ##
##### #  $ *.$@##### #  ###
##### #    ..$ # $   # ####
#####$#######$## # .   ####
# $            . #### #####
# $$# #########$##   .   ##
# # . .#      .  # $$*$$ ##
#   .  # $.$.#   #... ...##
##### $ # ## ##### $$*$$ ##
#####.#    #         .   ##
###########################
