###################
###########       #
######  ### $     #
###  #  ####.#    #
###   $ $   .#### #
###  $#$## #.#....#
### # $  # #.#....#
#  $ $  # #..*....#
# # ## $  # ####  #
#  $ # # $#      ##
##  $  #    #######
###  $ # $$$#######
#### $$@##  #######
#####      ########
###################
