###################
####     #     ####
#### $ $ $ $ $ ####
###### ##### ######
####.$   $   $.####
# ...# $ # $ #... #
#  $##*#.#.#*##$  #
##   . . @ . .   ##
#  $##*#.#.#*##$  #
# ...# $ # $ #... #
####.$   $   $.####
###### ##### ######
#### $ $ $ $ $ ####
####     #     ####
###################
