#####################
####        #########
###    ###  #########
## $$ #    $#  #  ###
##  ###  #$$      ###
##    $$ #     #$$###
##  #   #### #$   ###
### # ###.*. # ## ###
## *.*.#..*.##    ###
#  ***...**.### $$  #
# #....#...#  #   # #
#  ## ##.*. $ # ### #
##  # $ ..##   $  # #
### # $$### $#$$  # #
###  @  #   $    #  #
#######   ##$####  ##
############      ###
#####################
