############################
##    #   ##################
## $  #   ##################
#### $$   #######  ####   ##
## $  $  ###   ##  $      ##
# $   ###  # # ##  ##### ###
#  #$#       ..### ##  #   #
#    #  #.# #.. #   # $  $ #
### $ $ #.# #.. #   #  ## ##
###  #  #.#  #### #### ##  #
#########.#         # $  $ #
##  ..  #.# ######  #   #  #
##.$$$$.#.# #####  #### ####
##.$ @$.#.# #####  $      ##
##.$$$$.#.# #####  ####   ##
##  ..   .  ################
############################
