###########################
#   ###################   #
# # $ $ $ $ $ $ $ $ $ $ # #
# $ #     #     #     # $ #
##  #.###.#.###.#.###.#  ##
##$ #  .  #  *  #  .  # $##
##  .  #  .  #  .  #  .  ##
##$###.#.###.@.###.#.###$##
##  .  #  .  #  .  #  .  ##
##$ #  .  #  *  #  .  # $##
##  #.###.#.###.#.###.#  ##
# $ #     #     #     # $ #
# # $ $ $ $ $ $ $ $ $ $ # #
#   ###################   #
###########################
