#############################
#############   #############
#########   # $ #   #########
#####   # $$     $$ #   #####
#   #$$ .   ##$##   . $$#   #
# $$.   ##### . #####   .$$ #
#   #####   ##.##   #####   #
##$ #   #.... . ....#   # $##
##  . $ .   # @ #   . $ .  ##
##$ #   #.... . ....#   # $##
#   #####   ##.##   #####   #
# $$.   ##### . #####   .$$ #
#   #$$ .   ##$##   . $$#   #
#####   # $$     $$ #   #####
#########   # $ #   #########
#############   #############
#############################
