###################
##               ##
##$#.#.#.#.#.#.#$##
#  $.$.$.$.$.$.$  #
#  #$#$ $@$ $#$#  #
#  $.$.$.$.$.$.$  #
##$#.#.#.#.#.#.#$##
##               ##
###################
