#############
##    #    ##
# $$*.$.*$$ #
#...     ...#
# $$*.$.*$$ #
##    *    ##
# $$*.$.*$$ #
#...  @  ...#
# $$*.$.*$$ #
##    #    ##
#############
