##############################
##########  ###  #############
########## $ $   #############
#######   $   #$   ##  #######
####### ### ###        #  ####
#######  $   ###### #     ####
######  $ # ##    #####   ####
###### # #  #  # $$ # ## #####
###### #    #$.## $        ###
###### ######   $  # ###   ###
######....*.**.# #   ###   ###
#########      # #############
#########$## ###$#############
########  #   $  #############
#######   # $    #############
# $      ###### ##         @ #
#        .........           #
##############################
