#################
####### . #######
####### . #######
###   $ . $   ###
### $ ##.## $ ###
###   # $ #   ###
###$##     ##$###
#   #  ***  #   #
#....$ *@* $....#
#   #  ***  #   #
###$##     ##$###
###   # $ #   ###
### $ ##.## $ ###
###   $ . $   ###
####### . #######
####### . #######
#################
