##############################
##########  #. ###############
###        $ * ###############
### ## ##   #. #   ###########
### # $ $$#$#. # # ########  #
#  $#   #  $ * #......       #
# $    ### $#.  #  ####      #
## # #$$ # $ .# #  #####     #
## #   $   @##  # #######   ##
##  ##  $$$ #  ## ############
###  #.##.###       ##########
#### #*$.*...  ##   ##########
####   #   ##  ##  ###########
######   #####################
##############################
