##############################
#################   ##########
### $ $ $ $ $    $ $ $ $ $ ###
###     #         #        ###
#  #.##.#.##.#.##.#.##.#.##  #
# $#  .$ $  $#  .$ $  $#  .$ #
#  .  #$  $ $.  #$  $ $.  #  #
# $##.#.##.#.##.#.##.#.##.#$ #
##      .  #   @  .  #      ##
##      #  .      #  .      ##
# $#.##.#.##.#.##.#.##.#.##$ #
#  #  .$ $  $#  .$ $  $#  .  #
# $.  #$  $ $.  #$  $ $.  #$ #
#  ##.#.##.#.##.#.##.#.##.#  #
###        #         #     ###
### $ $ $ $ $    $ $ $ $ $ ###
##########   #################
##############################
