#################
######## ########
#######   #######
###### $.$ ######
#####  . .  #####
#### $.$.$.$ ####
###  . # # .  ###
## $.$# $ #$.$ ##
#  . . $@$ . .  #
## $.$# $ #$.$ ##
###  . # # .  ###
#### $.$.$.$ ####
#####  . .  #####
###### $.$ ######
#######   #######
######## ########
#################
