#######################
#####  ################
#####  $ $  ###########
#####   $     ######  #
#####*#*#$$$  ##### $ #
#     $ $   $ ####    #
#  #$    $ $##### $$ ##
## # ####  .....#   ###
#      # $  **.## #####
#   #  # $$ #.##.   ###
##     #    #.#+* # ###
##     ######.##..$ ###
########## $..##.######
########## # *..*.#####
##########   .#.  #####
###############$# #####
###############   #####
#######################
