#############################
###############  ############
############  $   ###*#######
#########  $   $  #######  ##
##  $ $ $   $ ##  #######  ##
## $     $ #### $ #######   #
#   $$ ##### $   ##      #  #
#  ## ##  $   $  #          #
#.#  $ # $ $  ####  ## ##   #
#.#  $ $ $ ####        #    #
#.#.#   $  #           #    #
#.#.  ###  #     ########   #
#.#.###@#### ##  #         ##
#.............   # ######  ##
#  .########### ## ##########
###############    ##########
#############################
