###############
##    #   #  ##
# .##$$  $  . #
#  ...#.#.#.# #
## # $ $   .# #
# $. # # #$.$ #
#  #  $ $  #$##
#  .$# @ #$.  #
##$#  $ $  #  #
# $.$# # # .$ #
# #.   $ $ # ##
# #.#.#.#...  #
# .  $  $$##. #
##  #   #    ##
###############
