#####################
####### #############
######   ############
#####  .  ###########
#### $.$.$ ##### ####
### $.$.$.$ ### . ###
##  .$.$.$.  # $.$ ##
#  .$.$@$.$.    *   #
##  .$.$.$.  # $.$ ##
### $.$.$.$ ### . ###
#### $.$.$ ##### ####
#####  .  ###########
######   ############
####### #############
#####################
