#################
#################
#######    ######
###   ..$$ #  ###
### $ $ .#@#$ ###
##### # *##   ###
##   #  *  #$.###
## $##  .    . ##
## $.**.#.**.$ ##
## .    .  ##$ ##
###.$#  *  #   ##
###   ##* # #####
### $# #. $ $ ###
###  # $$..   ###
######    #######
#################
#################
