###############
###########   #
### $ $ $ $.  #
#  .$.$ $.$.# #
# #.*..@..*.# #
# #.$.$ $.$.  #
#  .$ $ $ $ ###
#   ###########
###############
