###############
##     *     ##
#  ##.# ##.#  #
# # $ $ $ $ # #
# .$. ##  .$# #
# #  # . #  . #
# #$  $.$ #$# #
#*  #..@..#  *#
# #$# $.$  $# #
# .  # . #  # #
# #$.  ## .$. #
# # $ $ $ $ # #
#  #.## #.##  #
##     *     ##
###############
