#############
########  ###
#@ $ $ $$ ###
#  ....*.*  #
## ### ..*# #
##$$  # .*  #
## # $ #.*# #
##   $ #..  #
###  $    ###
##### #$#.###
#### $ $  ###
####     ####
#############
