#################
####### . #######
#### ##$.$## ####
#####   .   #####
## ## $$.$$ ## ##
###  ## . ##  ###
### $##$.$##$ ###
# $ $ $...$ $ $ #
#.......@.......#
# $ $ $...$ $ $ #
### $##$.$##$ ###
###  ## . ##  ###
## ## $$.$$ ## ##
#####   .   #####
#### ##$.$## ####
####### . #######
#################
