#############
##  # @ #  ##
#  $#$ $#$  #
# . . . . . #
###$#$ $#$###
# . . . . . #
#  $ $#$ $  #
# . . . . . #
###$#$ $#$###
# . . . . . #
#  $#$ $#$  #
##  #   #  ##
#############
