#################
##    #####    ##
# *.   ###   .* #
# $# $ $ $ $ #$ #
#   # .* *. #   #
#  . #  $  # .  #
##  $ ##$## $  ##
###.* # . # *.###
###  ..$@$..  ###
###.* # . # *.###
##  $ ##$## $  ##
#  . #  $  # .  #
#   # .* *. #   #
# $# $ $ $ $ #$ #
# *.   ###   .* #
##    #####    ##
#################
