###############
#    #   #    #
# #  #   #  # #
#  **$***$**  #
#  * .   . *  #
###$.## ##.$###
#  * #   # *  #
#  *   @   *  #
#  * #   # *  #
###$.## ##.$###
#  * .   . *  #
#  **$***$**  #
# #  #   #  # #
#    #   #    #
###############
