###########################
############ . ############
###########.$ $.###########
########## $ * $ ##########
##########. * * .##########
########## $ * $ ##########
###########.$ $.###########
############ . ############
##     ##  ## ##  ##     ##
# .$.$. #   # #   # $.$.$ #
# $.$.$ ##### ##### .$.$. #
# .$ $.             $.@.$ #
# $.$.$ ########### .$.$. #
# .$.$. ########### $.$.$ #
##     #############     ##
############***############
###########################
