#####################
####    ####   ######
###  ##  $   # ######
### # .# $# $  ######
### #$.$  #   #######
###  $. # ### #     #
##### .$. . # #.$.$ #
#### $. ###$#$# ## ##
####  #$        #   #
#   # $ ###@###.    #
# $     #  #..  #..##
###### #    ..# .  ##
#####   $$ #..## ..##
#####  $ $##     # ##
##### $$       #   ##
#####  ##############
#####################
