###################
####    #  @ ######
##    # $  #    ###
#   #..*.#*...#  ##
# # . $# $ $# .  ##
#   .#    #  $.#  #
#  #.$  #$   #*   #
##. * #  $ #  .$# #
# $ #$ $$#$$ $# $ #
# #$.  # $  # * .##
#   *#   $#  $.#  #
#  #.$  #    #.   #
##  . #$ $ #$ . # #
##  #...*#.*..#   #
###    #  $ #    ##
######    #    ####
###################
