##################
###############  #
##  #########  ..#
##  $ @ $   $ #..#
## $# $   # # #..#
##  ##*##$#$#$#..#
## $ #..#.      ##
##   #*. .##$## ##
##$ $#..#.      ##
#    ##$##########
#   $$ $ #########
##       #########
##################
