#####################
#   #   #######  #  #
# .$. $       # . . #
## ### # # # $ $ #$ #
# . #  #.$ $.## ##.##
#  $ .$ .# #. #. #  #
### ## #.$ $.  $  $ #
##  #  ##$$ .## ##  #
#  ## ##. $$##  #  ##
# $  $  .$ $.# ## ###
#  # .# .# #. $. $  #
##.## ##.$ $.#  # . #
# $# $ $ # # # ### ##
# . . #   @   $ .$. #
#  #  #######   #   #
#####################
