#############################
###           #           ###
###$$ $$ $$ $$.$$ $$ $$ $$###
# $+.$..$..$..$..$..$..$..$ #
# $..$..$..$..$..$..$..$..$ #
#  $$.$$.$$.$$.$$.$$.$$.$$  #
# $..$..$..$..$..$..$..$..$ #
# $..$..$..$..$..$..$..$..$ #
##.$$.$$.$$.$$ $$.$$.$$.$$.##
# $..$..$..$..$..$..$..$..$ #
# $..$..$..$..$..$..$..$..$ #
#  $$.$$.$$.$$.$$.$$.$$.$$  #
# $..$..$..$..$..$..$..$..$ #
# $..$..$..$..$..$..$..$..$ #
###$$ $$ $$ $$.$$ $$ $$ $$###
###           #           ###
#############################
