###########################
############ @ ############
##  .     .  #    .$.    ##
## .$.$$$.$. #.$  $.$  $.##
##.$$$.*.$$$.#$.*** ***.$##
## .$.$$$.$. #.$  $.$  $.##
#   .     .  #    .$.     #
# ####################### #
#   $.   .$  # $       .  #
##  * .$. *  # .**   **$ ##
##  $.$*$.$  # *  ***  * ##
##  * .$. *  # $**   **. ##
##  $.   .$  # .       $ ##
############ * ############
###########################
