##################
#####  ###########
#### $   .########
#### $ # .   $ $ #
#### ### .#### # #
#  ....#$.#  # # #
# #. $ # .#$ # # #
#  ##  $$$@$ # # #
##   ##  #   # # #
####   #  ## # # #
###### # ...     #
###### #$* *$#  ##
###### # ...$ ####
###### $$ #   ####
######   #########
##################
