#############################
###     ######     ##########
###.###  ##  .  ##  #########
### .  #  $*# .#  #  ########
### #.  ###.#  *$  # ########
### $ *    ###  .  #       ##
####$# * $$  ##$ .########  #
##  $ # *  #  # # .   #   # #
#  $$  $#. .# @ #. .#$  $$  #
# #   #   . # #  #  * # $  ##
#  ########. $##  $$ * #$####
##       #  .  ###    * $ ###
######## #  $*  #.###  .# ###
########  #  #. #*$  #  . ###
#########  ##  .  ##  ###.###
##########     ######     ###
#############################
