##############################
#        .........           #
# $      ###### ##         @ #
#######   # $    #############
########  #   $  #############
#########$## ###$#############
#########    ..# #############
######  ..*.**.# #   ###   ###
###### ######.. $  # ###$  ###
###### #    #*. # $        ###
###### # #  #  # $$ # ## #####
######  $ # ##    #####   ####
#######  $   ###### #     ####
####### ### ###       $#  ####
#######   $   #$ $ ##  #######
########## $ $    ############
##########  ####  ############
##############################
