##################
####           ###
###  #########@###
##  #         *  #
#  ## ########*# #
# #  $ $ $ $   # #
# #$.. . . ..$#  #
# # .#######. # ##
#  $.#######.$# ##
### . . . . . # ##
### $ $ $ $ $ # ##
########### ##  ##
########### $ $ ##
###########     ##
##################
