###########################
##  #  #  #  #  #  #  #  ##
## $#$ # $#$ # $#$ # $#$ ##
##  #  #  #  #  #  #  #  ##
## $#$ # $#$ # $#$ # $#$ ##
##  #  #  #  #  #  #  #  ##
### # ### # ### # ### # ###
##  #  #  #  #  #  #  #  ##
##  $  #  $  #  $  #  $  ##
## ### # ### # ### # ### ##
#   #  #  #  #  #  #  #   #
#   #  $  #  $  #  $  #   #
##  # ### # ### # ### #  ##
##...........+...........##
##########   #   ##########
##########  ###  ##########
###########################
