#############################
##  #####################  ##
##    ....... @ .......    ##
##  # .###############. #  ##
###  #.    #  #   #   .#  ###
##     #   $  #   $  #     ##
##     ##$##  ##$##  #     ##
####   #  ##$##  #####   ####
##  #  #  $   $  $   #  #  ##
##     #  #   #  #   #     ##
##  #  #####$######$##  #  ##
###   ##   #  #   #  ##   ###
########   $  #   $  ########
#########$##  ##$##  ########
########  #####  ##$#########
#    ###  $   $  $   ###    #
########  #   #  #   ########
#############################
