###################
##############  ###
######  . .   . . #
###### $$.$# #$.$ #
####### . .# #. . #
####### $ $#  $ $ #
####### $  #* #####
########## # ######
######   @   ######
###### # ##########
##### *#  $ #######
# $ $  #$ $ #######
# . .# #. . #######
# $.$# #$.$$ ######
# . .   . .  ######
###  ##############
###################
