#############
#############
##   #  #  ##
## $ #$ $  ##
##$.*.*.#* ##
## .    $. ##
##$.$#.  .$##
## .$   #* ##
#  .#.*##.  #
# $ $   $   #
### # # #####
####@   #####
#############
