#################
##  #   #   #  ##
#   **.. ..**   #
#  *   $$$   *  #
##* .### ###. *##
# * ## $@$ ## * #
# . #       # . #
# .$#$ ### $#$. #
## $   # #   $ ##
# .$#$ ### $#$. #
# . #       # . #
# * ## $ $ ## * #
##* .### ###. *##
#  *   $$$   *  #
#   **.. ..**   #
##  #   #   #  ##
#################
