#################
### # ##### # ###
##  #   #   #  ##
## $* $   $ *$ ##
#   ..*# #*..   #
###*..  #  ..*###
## $ *$ # $* $ ##
##   #  *  #   ##
### ###* *### ###
##   #  *  #   ##
## $ *$ # $* $ ##
###*..  #  ..*###
#   ..*#@#*..   #
## $* $   $ *$ ##
##  #   #   #  ##
### # ##### # ###
#################
