#################
########  #######
###### $   ######
##### $  *$ #####
#### $.#.$.$ ####
### $.$. .$.$ ###
## $.$. . .$.$ ##
#  *$. * * .# $##
#   . . @ . .   #
##$ #. * * .$*  #
## $.$. . .$.$ ##
### $.$. .$.$ ###
#### $.$.#.$ ####
##### $*  $ #####
######   $ ######
#######  ########
#################
