###############
###### @ ######
###### $ ######
###### $ ######
###### $ ######
#####.*.*.#####
#    *. .*    #
# $$$. # .$$$ #
#    *. .*    #
#####.*.*.#####
###### $ ######
###### $ ######
###### $ ######
######   ######
###############
