#################
#######   #######
####### $ #######
###### $.$ ######
##### $ * $ #####
#### $.*.*.$ ####
### $.*.#.*.$ ###
#  $ *.# #.* $  #
# $.*.#   #.*.$ #
#  $ *.# #.* $  #
### $.*.#.*.$ ###
#### $.*.*.$ ####
##### $ * $ #####
###### $.$ ######
####### $ #######
####### @ #######
#################
