###################
#######     #######
######  *.*  ######
###### #$ $# ######
######  *.*  ######
##   ##     ##   ##
#  #  ###.###  #  #
# *$* # $*$ # *$* #
# . . ..$@$.. . . #
# *$* # $*$ # *$* #
#  #  ###.###  #  #
##   ##     ##   ##
######  *.*  ######
###### #$ $# ######
######  *.*  ######
#######     #######
###################
