##################
############  ####
########## $$ ####
###   #   .*.$ ###
#  $$ # #....$ ###
# $.. # $ $    ###
##$*. ##  ########
## ..$## ###   ###
### .  #    $# ###
### #$   @#  . ###
###   ### ##$.. ##
########  ## .*$##
###    $ $ # ..$ #
### $....# # $$  #
### $.*.   #   ###
#### $$ ##########
####  ############
##################
