###############
##     @     ##
##**.*****.**##
##  $     $  ##
##   # ###   ##
######   ######
######## ######
#             #
#**.*******.**#
#  $       $  #
#   #######   #
###############
