###########################
###########################
####    #    #    #    ####
### .$$. .$$. .$$. .$$. ###
## .*  *.*  *.*  *.*  *. ##
## $ ## $ ## $ ## $ ## $ ##
## $ ## $ ## $ ## $ ## $ ##
## .*  *.*  *.*  *.*  *. ##
### .$$. .$$.@.$$. .$$. ###
## .*  *.*  *.*  *.*  *. ##
## $ ## $ ## $ ## $ ## $ ##
## $ ## $ ## $ ## $ ## $ ##
## .*  *.*  *.*  *.*  *. ##
### .$$. .$$. .$$. .$$. ###
####    #    #    #    ####
###########################
###########################
