#############################
#############################
########   ##   ##   ########
####   # $$   #   $$ #   ####
#  #$$     #.. ..#     $$#  #
#      ### #.###.# ###      #
#* ##### ### #*# ### ##### *#
#           ..@..           #
#* ##### ### #*# ### ##### *#
#      ### #.###.# ###      #
#  #$$     #.. ..#     $$#  #
####   # $$   #   $$ #   ####
########   ##   ##   ########
#############################
#############################
