#############################
############# @ #############
##            #            ##
##$.$  .$.$.$.#**.**$$$*.**##
##.$.$.$.$.$.$#  $. ..$.$  ##
##$.$.$.$.$.$.#  $.$.. .$  ##
##.$.$.$.  $.$#**.*$$$**.**##
#             #             #
# ######################### #
#    ..  ..   # $ . $. $ .  #
## $*$*$$$$*$ #  $ $.$. .  ##
## *. .. .$.$ #.$.$.  $.$.$##
## $.$. .. .* #$.$.$  .$.$.##
## $*$$$$*$*$ #  . .$.$ $  ##
##   ..  ..   # . $ .$ . $ ##
############# * #############
#############################
