#######################
##   #   #   #   #   ##
# * * * * * * * * * * #
#  # # # # # # # # #  #
# $.$ $.$ $.$ $.$ $.$ #
##. .#. .#. .#. .#. .##
# $.$ $.$ $.$ $.$ $.$ #
#  # # # # # # # # #  #
# $.$ $.$ $.$ $.$ $.$ #
##. .#. .#.@.#. .#. .##
# $.$ $.$ $.$ $.$ $.$ #
#  # # # # # # # # #  #
# * * * * * * * * * * #
##   #   #   #   #   ##
#######################
