#####################
###   ############..#
###  $# $ $ $ $  $  #
#### $  # # # #$  ..#
####  # . . . *..   #
#### $####@## # ## ##
## ## # ## ####$ ####
#   ..* . . . #  ####
#..  $# # # #  $ ####
#  $  $ $ $ $ #$  ###
#..############   ###
#####################
