##############################
####     ##########  ##  #####
#### ### ##########$    $#####
#  #     ######      ## $ ####
#     #    #### $ $$$##   ####
#     #    #####$  #  ### ####
### ##### ##   #  $# $    ####
#   #  #       #$  #  ########
#      #   #  ##  ## #  ######
#   #  ####   ## # $ $  ######
##### ##      ## #   #  ######
####       ####  ##### #######
####   #      #    # $$$ #  ##
####   #      ## $        $  #
########### ############## # #
######### @..................#
######### # ##################
#########   ##################
##############################
