#############
########### #
###        ##
## *$.$.$* ##
##  *###*  ##
## $#   #$ ##
##.. .@. ..##
## $#   #$ ##
##  *###*  ##
## *$.$.$* ##
##        ###
# ###########
#############
