##################
###########  #####
###########  #####
###########  #####
############ #####
#    $ $.* $$#####
# @  $..*.*. #####
#   # *  $ .$#####
#####*.$   *.#####
#####.*   $.*#####
#####$. $  * #####
##### .*.*..$#   #
#####$$ *.$ $    #
##### ############
#####  ###########
#####  ###########
#####  ###########
##################
