#############
##  #####  ##
#   #####   #
#  $. * .$  #
###.$.$.$.###
### .$ $. ###
###*$ @ $*###
### .$ $. ###
###.$.$.$.###
#  $. * .$  #
#   #####   #
##  #####  ##
#############
