#################
#####       #####
#####$#$ $#$#####
### . . . . . ###
###$#$#$ $#$#$###
# . . . . . . . #
# #$#$#$#$#$#$# #
# . . .   . . . #
###$#$##@##$#$###
# . . .   . . . #
# #$#$#$#$#$#$# #
# . . . . . . . #
###$#$#$ $#$#$###
### . . . . . ###
#####$#$ $#$#####
#####       #####
#################
