###############################
#              #####     ######
#  $ $ $ $ ### ##### ### ######
# $ $ $ $ $  . #    $  . ######
#  $ $ ### #.#.# ### #.#.######
# $ $ $  . # .  $  . # .   ####
## ### #.#.# ### #.#.# ### ####
##   . # .  $    # .  $ $.$####
####.#.# ### # @ # ### #.#.####
####$.$ $  . #    $  . # .   ##
#### ### #.#.# ### #.#.# ### ##
####   . # .  $  . # .  $ $ $ #
######.#.# ### #.#.# ### $ $  #
###### .  $    # .  $ $ $ $ $ #
###### ### ##### ### $ $ $ $  #
######     #####              #
###############################
