########################
###      #    #      ###
###$.$  $.$  $.$  $.$###
# $. .$$.#.$$. .$$.#.$ #
# .###.. # ..###.. # . #
# $. .$$.#.$$. .$$.#.$ #
#  $.$  $.$  $.$  $.$  #
#  $.$  $.$  $.$  $.$  #
# $.#.$$. .$$.#.$$. .$ #
##. # ..###.. # ..###.##
# $.#.$$. .$$.#.$$. .$ #
#  $.$  $.$  $.$  $.$  #
#  $.$  $.$  $.$  $.$  #
# $. .$$.#.$$. .$$.#.$ #
##.###.. # ..###.. # .##
# $. .$$.#.$$. .$$.#.$ #
#  $.$  $.$  $.$  $.$  #
#  $.$  $.$  $.$  $.$  #
# $.#.$$. .$$.#.$$. .$ #
# . # ..###.. # ..###. #
# $.#.$$. .$$.#.$$. .$ #
###$.$  $.$  $.$  $.$###
###      #    #     @###
########################
