#####################
######  #############
######  .      ######
######  ### $$ ######
###### $#  # .$######
######  # . .#.######
##  $.  #  # .    $ #
## $.#.###$###  $   #
## $ . #.   .#####.##
##  # ## *$$ #   # ##
## # . $ $@$ $ . # ##
## #   # $$* ## #  ##
##.#####.   .# . $ ##
#   $  ###$###.#.$ ##
# $    . #  #  .$  ##
######.#. . #  ######
######$. #  #$ ######
###### $$ ###  ######
######      .  ######
#############  ######
#####################
