#####################
#####   #####   #####
#####   #####   #####
### .$.$. #  $.$  ###
### $.$.$ #.$.$.$.###
#  $.$.$.$ $.$.$.$  #
#  .$.$.$. .$.$.$.  #
#  $.$.$.$ $.$.$.$  #
### $.$.$ #.$.$.$.###
### .$.$. .  $.$  ###
#####   #.@.#   #####
###  $.$  . .$.$. ###
###.$.$.$.# $.$.$ ###
#  $.$.$.$ $.$.$.$  #
#  .$.$.$. .$.$.$.  #
#  $.$.$.$ $.$.$.$  #
###.$.$.$.# $.$.$ ###
###  $.$  # .$.$. ###
#####   #####   #####
#####   #####   #####
#####################
