#######################
##########   ##########
#########.$.$.#########
#########$.$.$#########
######## .$.$. ########
######## $.$.$ ########
######## .$.$. ########
######## $.$.$ ########
####     .$.$.     ####
##.$.$.$.$.$.$.$.$.$.##
# $.$.$.$.$ $.$.$.$.$ #
# .$.$.$.$ @ $.$.$.$. #
# $.$.$.$.$ $.$.$.$.$ #
##.$.$.$.$.$.$.$.$.$.##
####     .$.$.     ####
######## $.$.$ ########
######## .$.$. ########
######## $.$.$ ########
######## .$.$. ########
#########$.$.$#########
#########.$.$.#########
##########   ##########
#######################
