##############################
##                        ####
# *.*.* *.*.* *.*.* *.*.* ####
# .$ $.$.$ $.$.$ $.$.$ $. .###
# * $ * * $ * * $ * * $ *#   #
# .$ $.*.$ $.*.$ $.*.$ $.*.* #
# *.*.$ $.*.$ $.*.$ $.*.$ $. #
#  $ * $ * * $ * * $ * * $ * #
# *.*.$ $.*.$ $.*.$ $.*.$ $. #
# .$ $.*.$ $.*+$ $.*.$ $.*.* #
# * $ * * $ * * $ * * $ * $  #
# .$ $.*.$ $.*.$ $.*.$ $.*.* #
# *.*.$ $.*.$ $.*.$ $.*.$ $. #
#   #* $ * * $ * * $ * * $ * #
###. .$ $.$.$ $.$.$ $.$.$ $. #
#### *.*.* *.*.* *.*.* *.*.* #
####                        ##
##############################
