#######################
########### ###########
##########   ##########
#########  $  #########
########  $ $  ########
####### .$.$.$. #######
###### .$.$.$.$. ######
##### .$.$.$.$.$. #####
#### .$.$.$.$.$.$. ####
###  $.$.$. .$.$.$  ###
##  $.$.$.   .$.$.$  ##
#  $ $.$.  @  .$.$ $  #
##  $.$.$.   .$.$.$  ##
###  $.$.$. .$.$.$  ###
#### .$.$.$.$.$.$. ####
##### .$.$.$.$.$. #####
###### .$.$.$.$. ######
####### .$.$.$. #######
########  $ $  ########
#########  $  #########
##########   ##########
########### ###########
#######################
