###################
###    ############
##  ##  ####     ##
## #  # ###  ###  #
## #  # ### #   # #
## #  $  #  $   # #
##  #$#*.#.*#$##  #
###   *.$ $.*    ##
##### .$ . $. #####
####### .#. #######
##### .$ . $. #####
##    *.$@$.*   ###
#  ##$#*.#.*#$#  ##
# #   $  #  $  # ##
# #   # ### #  # ##
#  ###  ### #  # ##
##     ####  ##  ##
############    ###
###################
