####################
#   #   ############
# $$#$$ @###########
#    $  ############
#   # ##############
####  $ #     #....#
#### $$ #$ $ $#....#
####  $     $ #....#
#### $$$#$  $ #  ..#
####    #  $ $   ..#
###############  ..#
###############  ..#
####################
