################
############   #
##     $    ...#
##$$#  #####...#
##  #$ #   #...#
#  $   #   #...#
#@#$$ ##   #...#
# $    #   #...#
##  $$ ######.##
## $ $ #   #   #
##$ $ $ $ $    #
##  ## #  $$# ##
##     ###    ##
################
