#################
#####.......#####
#####.......#####
#####.......#####
######## $#######
######  $  ######
###### $ $  #####
####### # # #####
##  ## $ $ $  ###
## $$         ###
#   #####$##$####
#   $     $ $ ###
######## $#     #
######  $ #  #  #
######   @#$  $ #
####### $ $   $ #
##############  #
#################
