#################
########.....####
# $   $ .....####
#  $ $ #.....   #
##  ## #.....#  #
##  $  ###$### ##
## $  $  $   $ ##
##$####  $   $ ##
##   #  $# ######
####   $$ $ $  ##
####### $  $   ##
######@  ########
#################
