####################
####    ############
##        ##########
## #$$$## #  #######
## #    # #  #######
## #    # # $   ...#
## #$#$## #$    ...#
##         $$###...#
#  #$$$## #$   #...#
# #     # #    #...#
# #  $  # # ## #...#
#  #$#$##  #   #...#
##       $   $ #...#
## #$$$# ####$##.###
## # @ #  #  $   ###
##  ###   # $$ #####
###     ###    #####
####################
