##################
#######   ########
###@$    $   $  ##
##### #$#  ##$  ##
##  #  $  $ #   ##
##  ### ##  # ####
##  $ # $  #  $  #
##        ### $  #
#######$ ##  $ ###
#.....#  #  $  ###
#.....## $ #$  ###
#....     $   ####
#...   ###########
##################
