###############
#####.........#
##   .*******.#
## ###.......##
## # #.$$$$$.##
#@ ####     ###
# $  ## $$$ ###
# $ $  #   ####
# $ $ $    ####
# $ $ $  ######
# $ $  ########
# $  ##########
#  ############
###############
