##########
#  ####  #
#   @    #
# $$$$$$ #
##      ##
# $$$$$$ #
#        #
#  $$$$  #
###    ###
## $$$$ ##
##      ##
##  $$  ##
####..####
##..**..##
##......##
##..##..##
##......##
##########
