###############
###....   ..###
### .......####
### .#....#####
#  #$##..##   #
#     #### $  #
# $$  #  #  $ #
##  $$#   $$ ##
##$  $   #$  ##
## $$ #  #  $##
## $ $#### $ ##
##       #  ###
##### $  # ####
####### ## ####
###### $   ####
######@ #  ####
###############
