##################
##############  ##
#######     #   ##
####### ###   # ##
#####     $   # ##
#   $ $ ###$$ # ##
#  $ $$$  # $## ##
#  #$   #  $  # ##
##   #### ### #$##
## ###......     #
##   $......## # #
## ###......##   #
##$$ #   #########
##     # $@$ #####
########     #####
##################
