###################
###########  ###  #
###########  $    #
########### # $ $ #
########### # #  ##
#######.....# $$$##
#######....* $   ##
#######*..*.# #$###
#######....*# $  ##
#     $*.*..#    ##
#  $$ # ##$###$$ ##
#    $   #      ###
#####$ $ ####  ####
##@# $        #####
##    ######  #####
###################
