###################
#######   #########
######  *  ########
#####  * *  #######
####  * * *  ######
###  * * * *  #####
##  * * * * *  # ##
#  * * * * * *    #
# * * * . * * *@$ #
#  * * * * * *    #
##  * * * * *  # ##
###  * * * *  #####
####  * * *  ######
#####  * *  #######
######  *  ########
#######   #########
###################
