################
# ##############
#  ######  #####
#   # $ $$ $ ###
#  $ @ $    $  #
# $ # #$  $    #
#  ## # ### ####
# ##    #  $  ##
###... ## $ $ ##
##....##   $  ##
#....## $  $####
#...###  $  ####
#...###  #######
################
