################
############  ##
#######   $   ##
####### $$ $  ##
######## # $  ##
#######   $ # ##
##      $ $ $ ##
## ## #######  #
## $  ##...##$ #
##   ##...#.#  #
# $ $ #.....$$ #
#    $$.....#  #
##$   #..#..#$##
## $#$####### ##
##    #       ##
##### # # ######
#####   #@######
################
