####################
##   ###############
##$  ######    ##  #
## $$  $   $  $... #
# $ ##   #  #$#.#. #
#    ##  ##$ $ ... #
# $#    $ # # #.#. #
#  ## #$  #    ... #
# #  $#@$## # #.#. #
#  $$ #$ #  #  ... #
###      #  #   ####
#####   ##  ########
####################
