####################
#####  ....#########
## #  $....#########
## $  #....## ..####
##  $$## #### ....##
####    $ @## .....#
#    $ $$ #### #####
# #$$$$# $$ $  #####
#       # $ ## #####
###  ## $  $  $#####
### $   $      #####
######  $ ### $#####
########  ###  #####
####################
