##################
########   #######
#  ####  $   $   #
#  #### $ $ $ #  #
#... $ $  #$#$## #
#...# $ $        #
#..# $ $ $########
#...$ $ $@########
###### $ $ #######
###### ##  ..#####
###### #  ...#####
######    ...#####
##################
