####################
##    ###    #######
## ## ### $  #######
# $$     $$  #######
#  $ ## ## # #######
# # $ $    # #######
# $  $  # ## #######
#  # #$   ## ##    #
#### #  #### ## ## #
##  $ $##  #       #
## $ $     # ## ####
## ## ###  #   ....#
#   # ###   ## ....#
#   $$#       .....#
#   #    #@####....#
####################
