###########
####   # ##
### $.$  ##
## $.$.$ ##
## .$.$.###
# .$.$.$ ##
# $.$ $. ##
##.$.$.$.##
# $.$.$.$ #
#   . .   #
#####@#####
####  #####
#### ######
## #   ####
##  $.$ ###
## $.$.$ ##
###.$.$. ##
## $.$.$. #
## .$ $.$ #
##.$.$.$.##
# $.$.$.$ #
#   . .   #
###########
