################
########  ######
####### $  #####
#######  *  ####
###  .  * * ####
##  * * $* .####
#  * *$..$* ####
# $ *$.##.    ##
##    .##.$* $ #
#### *$..$* *  #
####. *$ * *  ##
#### * *@ .  ###
####  *  #######
#####  $ #######
######  ########
################
