##########
#  $.    #
#  *  *  #
# * ** *$#
#  * @* .#
#. *  *  #
#$* ** * #
#  *  *  #
#    .$  #
##########
