##########
#   .$   #
#  .$.$  #
# .$.$.$ #
#.$.##$.$#
#$.$##.$.#
# $.$.$. #
#  $.$.  #
#   $.  @#
##########
