###############
###  #####  ###
###.$#####$.###
# $  .$ $.  $ #
# .  $. .$  . #
###$.## ##.$###
###.$#   #$.###
###    @    ###
###$.#   #.$###
###.$## ##$.###
# $  .$ $.  $ #
# .  $. .$  . #
###$.#####.$###
###  #####  ###
###############
