###############
#####     #####
###    #    ###
## $#$.$.#.$ ##
## .$.#.$.$# ##
#  #.$.$.$.$  #
#  .$.$ $.#.  #
# #$.$ @ $.$# #
#  .#.$ $.$.  #
#  $.$.$.$.#  #
## #$.$.#.$. ##
## $.#.$.$#$ ##
###    #    ###
#####     #####
###############
