##################
########  ########
######## $########
########. .  #####
###### $ # $ #####
###  #  . .#######
### $####$ #  ####
###. . $. $# $####
# $ # $ **.#. .  #
#  . .#.** $ # $ #
####$ #$ .$ . .###
####  # $####$ ###
#######. .  #  ###
##### $ # $ ######
#####  . .########
########$ ########
######## @########
##################
