#############
#####  .$   #
####  .$.$  #
###  .$.$ $ #
##  .$.$.$.$#
#  .$.$.$.$.#
# .$.$@$.$. #
#.$.$.$.$.  #
#$.$.$.$.  ##
# $ $.$.  ###
#  $.$.  ####
#   $.  #####
#############
