###############
######   ######
###    #   ####
### #  $.#   ##
##  $.#.$.$# ##
## #.$.$ $.  ##
#  .$ $.$.#   #
# #$.$.@.$.$# #
#   #.$.$ $.  #
##  .$ $.$.# ##
## #$.$.#.$  ##
##   #.$  # ###
####   #    ###
######   ######
###############
