###########################
##    ###############    ##
# $ $ $.$ $ $.$ $ $.$ $ $ #
#  $.$ . $.$ . $.$ . $.$  #
# $.$.*.*.$.*.*.$.*.*.$.$ #
#  $.$ . $.$ . $.$ . $.$  #
##$ * $.$ $ $#$ $ $.$ * $##
##.....#.....#.....#.....##
##$ * $.$ $ $#$ $ $.$ * $##
## $.$ . $.$ . $.$ . $.$ ##
##$.$.$.$.$.*.*.$.$.$.$.$##
## $.$ . $.$ . $.$ . $.$ ##
##$ * $.$ * * * * $.$ * $##
##....###... @ ...###....##
##$ * $.$ * * * * $.$ * $##
## $.$ . $.$ . $.$ . $.$ ##
##$.$.$.$.$.*.*.$.$.$.$.$##
## $.$ . $.$ . $.$ . $.$ ##
##$ * $.$ $ $#$ $ $.$ * $##
##.....#.....#.....#.....##
##$ * $.$ $ $#$ $ $.$ * $##
#  $.$ . $.$ . $.$ . $.$  #
# $.$.*.*.$.*.*.$.*.*.$.$ #
#  $.$ . $.$ . $.$ . $.$  #
# $ $ $.$ $ $.$ $ $.$ $ $ #
##    ###############    ##
###########################
