#####################
#####################
##    #   #   #    ##
## #  #   #   #  # ##
##  **$***$***$**  ##
##  *   .   .   *  ##
####$ #### #### $####
##  * ## #.# ## *  ##
##  *.# ## ## #.*  ##
##  * ###   ### *  ##
####$  .  @  .  $####
##  * ###   ### *  ##
##  *.# ## ## #.*  ##
##  * ## #.# ## *  ##
####$ #### #### $####
##  *   .   .   *  ##
##  **$***$***$**  ##
## #  #   #   #  # ##
##    #   #   #    ##
#####################
#####################
