#######################
##  #      *      #  ##
#   # #   # #   # #   #
#  $.$.$ $.$.$ $.$.$  #
###.$.$.#.$.$.#.$.$.###
#  $. .$ $. .$ $. .$  #
# #.$.$.#.$.$.#.$.$.# #
#  $.$.$ $.$.$ $.$.$  #
#   # #   # #   # #   #
#  $.$.$ $.$.$ $.$.$  #
# #.$.$.#.$.$.#.$.$.# #
#* $. .$ $.@.$ $. .$ *#
# #.$.$.#.$.$.#.$.$.# #
#  $.$.$ $.$.$ $.$.$  #
#   # #   # #   # #   #
#  $.$.$ $.$.$ $.$.$  #
# #.$.$.#.$.$.#.$.$.# #
#  $. .$ $. .$ $. .$  #
###.$.$.#.$.$.#.$.$.###
#  $.$.$ $.$.$ $.$.$  #
#   # #   # #   # #   #
##  #      *      #  ##
#######################
