##############################
##############################
###    #    #    #    #    ###
## $.$.#.$.$#$.$.#.$.$#$.$. ##
## .$.$ $.$. .$.$ $.$. .$.$ ##
## $.$. .$.$ $.$. .$.$ $.$. ##
## .$.$#$.$. .$.$#$.$. .$.$ ##
####   #   ###   #   ###  ####
## .$.$#$.$. .$.$#$.$. .$.$ ##
## $.$. .$.$ $.$. .$.$ $.$. ##
## .$.$ $.$. .$.$ $.$. .$.$ ##
## $.$. .$.$#$.$. .$.$#$.$. ##
####  ###   #   ###   #   ####
## $.$. .$.$#$.$. .$.$#$.$. ##
## .$.$ $.$. . @$ $.$. .$.$ ##
## $.$. .$.$ $  . .$.$ $.$. ##
## .$.$#$.$. .$.$#$.$. .$.$ ##
####   #   ###   #   ###   ###
## .$.$#$.$. .$.$#$.$. .$.$ ##
## $.$. .$.$ $.$. .$.$ $.$. ##
## .$.$ $.$. .$.$ $.$. .$.$ ##
## $.$. .$.$#$.$. .$.$#$.$. ##
####  ###   #   ###   #   ####
## $.$. .$.$#$.$. .$.$#$.$. ##
## .$.$ $.$. .$.$ $.$. .$.$ ##
## $.$. .$.$ $.$. .$.$ $.$. ##
## .$.$#$.$.#.$.$#$.$.#.$.$ ##
###    #    #    #    #    ###
##############################
##############################
