#######################
########### ###########
########## # ##########
#########  #  #########
########   #   ########
#######    $    #######
######.*********.######
##### *         * #####
####  * ******* *  ####
###   * *     * *   ###
##    * * *** * *    ##
# ###$* * *@* * *$### #
##    * * *** * *    ##
###   * *     * *   ###
####  * ******* *  ####
##### *         * #####
######.*********.######
#######    $    #######
########   #   ########
#########  #  #########
########## # ##########
########### ###########
#######################
