#####################
########## ##########
######### . #########
######## $.$ ########
#######  .$.  #######
###### $.$ $.$ ######
##### $. . . .$ #####
#### $.$.$ $.$.$ ####
###  . . # # . .  ###
## $.$.$# $ #$.$.$ ##
# ..$    $@$    $.. #
## $.$.$# $ #$.$.$ ##
###  . . # # . .  ###
#### $.$.$ $.$.$ ####
##### $. . . .$ #####
###### $.$ $.$ ######
#######  .$.  #######
######## $.$ ########
######### . #########
########## ##########
#####################
