##########################
###    #######. . . .  ###
##.$.$.$     .$.$.$.$.$.##
# $.$.$.#####$.$.$.$.$.$ #
# .$.$.$#   # $.$.$.$.$. #
#.$.$.  # $     ####.$.$ #
# .$.##### ### ##  # .$. #
#.$.$#   #  # $  $ # $.$##
# .$.# $  $ # # #  #### ##
#.$.$## ##  #   # ##  # ##
# .$. #   ###### $  $ # ##
#.$.$  $# #    #   #  # ##
##.$  #   # ## ##### ## ##
## ## ##### ## #   #  $.##
## #  #   #    # #$  $.$.#
## # $  $ ######   # .$. #
## #  ## #   #  ## ##$.$.#
## ####  # # # $  $ #.$. #
##$.$ # $  $ #  #   #$.$.#
# .$. #  ## ### #####.$. #
# $.$.####     $ #  .$.$.#
# .$.$.$.$.$ #   #$.$.$. #
# $.$.$.$.$.$#####.$.$.$ #
##.$.$.$.$.$.  @  $.$.$.##
###  . . . .#######    ###
##########################
