###################################
###################################
###   ###   #   ###   #   ###   ###
## $.$. .$.$ $.$. .$.$ $.$. .$.$ ##
## .$.$ $.$. .$.$ $.$. .$.$ $.$. ##
## $.$. .$.$ $.$. .$.$ $.$. .$.$ ##
###.$.$#$.$. .$.$#$.$. .$.$#$.$.###
###    #   ###   #   ###   #    ###
###.$.$#$.$. .$.$#$.$. .$.$#$.$.###
## $.$. .$.$ $.$. .$.$ $.$. .$.$ ##
## .$.$ $.$. .$.$ $.$. .$.$ $.$. ##
## $.$. .$.$#$.$. .$.$#$.$. .$.$ ##
###   ###   #   ###   #   ###   ###
## $.$. .$.$#$.$. .$.$#$.$. .$.$ ##
## .$.$ $.$. .$.$ $.$. .$.$ $.$. ##
## $.$. .$.$ $.$. .$.$ $.$. .$.$ ##
###.$.$#$.$. .$.$ $.$. .$.$#$.$.###
###    #   ###   @   ###   #    ###
###.$.$#$.$. .$.$ $.$. .$.$#$.$.###
## $.$. .$.$ $.$. .$.$ $.$. .$.$ ##
## .$.$ $.$. .$.$ $.$. .$.$ $.$. ##
## $.$. .$.$#$.$. .$.$#$.$. .$.$ ##
###   ###   #   ###   #   ###   ###
## $.$. .$.$#$.$. .$.$#$.$. .$.$ ##
## .$.$ $.$. .$.$ $.$. .$.$ $.$. ##
## $.$. .$.$ $.$. .$.$ $.$. .$.$ ##
###.$.$#$.$. .$.$#$.$. .$.$#$.$.###
###    #   ###   #   ###   #    ###
###.$.$#$.$. .$.$#$.$. .$.$#$.$.###
## $.$. .$.$ $.$. .$.$ $.$. .$.$ ##
## .$.$ $.$. .$.$ $.$. .$.$ $.$. ##
## $.$. .$.$ $.$. .$.$ $.$. .$.$ ##
###   ###   #   ###   #   ###   ###
###################################
###################################
