###################
# $.$.  *.$ * $.  #
# .$ * $.*  .$.$  #
#@$.$. .$ * * $. ##
# .$ * * $. .$.$ ##
# $.$.  *.$ * $. ##
# .$ * $.*  .$.$ ##
###################
