###############
#   #######   #
# # #     # # #
#  $.$.$.$.$  #
###.$.$.$.$.###
## $.$ . $.$ ##
## .$     $. ##
## $.*.+.*.$ ##
## .$     $. ##
## $.$ * $.$ ##
###.$.$.$.$.###
#  $.$.$.$.$  #
# # #     # # #
#   #######   #
###############
