#############
####   ######
##    #    ##
## $.$.$.$ ##
## .$.$.$.  #
## $.$.$.$  #
# #.$.#.$.# #
#  $.$.$.$ ##
#  .$.$.$. ##
## $.$.$.$ ##
##    #    ##
######@  ####
#############
