############
##  #  #  ##
# @ *  *   #
#  $.$$.$  #
##*.$..$.*##
#  $.  .$  #
#  $.  .$  #
##*.$..$.*##
#  $.$$.$  #
#   *  *   #
##  #  #  ##
############
