###################
###. #   ##########
###.$    ##########
###.$###.#  @ #   #
###.$ # $$$ # # $ #
### $ #..#  #   * #
####  #  #  # ..*##
####*   .$ ##   * #
####  #  ###### $ #
##### ##      #   #
### $$ ##$.$.*#####
# ... .# .$.*  # ##
#   $$ # $.* $   ##
# # #  ###  #  # ##
#   ###### ##### ##
##########       ##
###################
