###############
#   #     #   #
# .$.$. .$.$. #
# $.$.$ $.$.$ #
##.$ $. .$ $.##
# $.$.$.$.$.$ #
# .$.$.$.$.$. #
#    .$@$.    #
# .$.$.$.$.$. #
# $.$.$.$.$.$ #
##.$ $. .$ $.##
# $.$.$ $.$.$ #
# .$.$. .$.$. #
#   #     #   #
###############
