#################
###     #     ###
##  # # # # #  ##
#  * * * * * *  #
# # * * # * * # #
#  * . * * . *  #
# # * * # * * # #
#  * * $ $ * *  #
### # # @ # # ###
#  * * $ $ * *  #
# # * * # * * # #
#  * . * * . *  #
# # * * # * * # #
#  * * * * * *  #
##  # # # # #  ##
###     #     ###
#################
