###############
######   ######
##   # . #   ##
## $ $.$.$ $ ##
##  *.$.$.*  ##
###$.$.$.$.$###
#  .$.$.$.$.  #
# .$.$.@.$.$. #
#  .$.$.$.$.  #
###$.$.$.$.$###
##  *.$.$.*  ##
## $ $.$.$ $ ##
##   # . #   ##
######   ######
###############
