###############
#  ############
#  ########  @#
#  * * * *    #
##  * * *  *###
##*  * *  * ###
## *  *  * *###
##* *   * * ###
## * *   * *###
##* *  *  * ###
## *  * *  *###
##.  * * *  ###
##  $ * * *  ##
###########  ##
###########  ##
###############
