#########################
#########  * *  #########
#########   .   #########
########## # # ##########
######## $ # # $ ########
######## $ # # $ ########
########  ## ##  ########
######## ##   ## ########
####      #.$.#      ####
#  #$$ #  . $ .  # $$#  #
#     ###.*.#.*.###     #
#* #### . .$ $. . #### *#
# .     $$# @ #$$     . #
#* #### . .$ $. . #### *#
#     ###.*.#.*.###     #
#  #$$ #  . $ .  # $$#  #
####      #.$.#      ####
######## ##   ## ########
########  ## ##  ########
######## $ # # $ ########
######## $ # # $ ########
########## # # ##########
#########   .   #########
#########  * *  #########
#########################
