#################################
################ ################
############### # ###############
##############  *  ##############
#############  * *  #############
############  * $ *  ############
############ * $#$ * ############
##########  . * $ * .  ##########
#########  * . * * . *  #########
########  * * . * . * *  ########
#######  * $ *  .  * $ *  #######
####### * $#$ * # * $#$ * #######
#####  . * $ *  *  * $ * .  #####
####  * . * * . * . * * . *  ####
###  * * . * .#* *#. * . * *  ###
##  * $ *     * $ *     * $ *  ##
# #* $#$ *.#** $@$ **#.* $#$ *# #
##  * $ *     * $ *     * $ *  ##
###  * * . * .#* *#. * . * *  ###
####  * . * * . * . * * . *  ####
#####  . * $ *  *  * $ * .  #####
####### * $#$ * # * $#$ * #######
#######  * $ *  .  * $ *  #######
########  * * . * . * *  ########
#########  * . * * . *  #########
##########  . * $ * .  ##########
############ * $#$ * ############
############  * $ *  ############
#############  * *  #############
##############  *  ##############
############### # ###############
################ ################
#################################
