#########################
###  #   ################
### $.$  ################
#   .$.$#################
# $. .$.$   #############
##.$. .$.$  #############
# $.$. .$.$##############
#  $.$. .$.$   ##########
#   $.$. .$.$  ##########
#####$.$. .$.$###########
####  $.$. .$.$   #######
####   $.$. .$.$  #######
########$.$.@.$.$########
#######  $.$. .$.$   ####
#######   $.$. .$.$  ####
###########$.$. .$.$#####
##########  $.$. .$.$   #
##########   $.$. .$.$  #
##############$.$. .$.$ #
#############  $.$. .$.##
#############   $.$. .$ #
#################$.$.   #
################  $.$ ###
################   #  ###
#########################
