#######################
########### ###########
##########   ##########
#########  *  #########
########  * *  ########
#######  * $ *  #######
####### * $#$ * #######
#####  . * $ * .  #####
####  * . * * . *  ####
###  * * . * . * *  ###
##  * $ * . . * $ *  ##
#  * $#$ * @ * $#$ *  #
##  * $ * . . * $ *  ##
###  * * . * . * *  ###
####  * . * * . *  ####
#####  . * $ * .  #####
####### * $#$ * #######
#######  * $ *  #######
########  * *  ########
#########  *  #########
##########   ##########
########### ###########
#######################
