###############
##  #######  ##
#      .      #
#  # ## ## #  #
##  #  $  #  ##
## #  *.*  # ##
## # * $ * # ##
##. $.$+$.$ .##
## # * $ * # ##
## #  *.*  # ##
##  #  $  #  ##
#  # ## ## #  #
#      *      #
##  #######  ##
###############
