#####################
#                   #
#.$.$.$.########### #
#$.$.$.$            #
#.$.$.$.########### #
#$.$.$.$            #
#.$.$.$.########### #
#$.$.$.$            #
#.$.$.$.########### #
#         $         #
# ################# #
#         @         #
#####################
