###################
###   #######   ###
##  * ####### *  ##
#  * *   +   * *  #
# * * *  $  * * * #
#  * * ## ## * *  #
### * #     # * ###
###  # * # * #  ###
###  #  # #  #  ###
###.$  # # #  $.###
###  #  # #  #  ###
###  # * # * #  ###
### * #     # * ###
#  * * ## ## * *  #
# * * *  $  * * * #
#  * *   .   * *  #
##  * ####### *  ##
###   #######   ###
###################
