###################
########   ########
###### $ #$$ ######
####  * . .#   ####
###  #$# . .$$  ###
### $ * .$# . # ###
##  $.#.#.$.#*$* ##
##$#. .$.$ $. # $##
# $. #$    .#. .  #
# # .$.$ @ $.$. # #
#  . .#.    $# .$ #
##$ # .$ $.$. .#$##
## *$*#.$.#.#.$  ##
### # . #$. * $ ###
###  $$. . #$#  ###
####   #. . *  ####
###### $$# $ ######
########   ########
###################
