#############################
#                           #
#.$.$.$.$.$.############### #
#$.$.$.$.$.$                #
#.$.$.$.$.$.############### #
#$.$.$.$.$.$                #
#.$.$.$.$.$.############### #
#$.$.$.$.$.$                #
#.$.$.$.$.$.############### #
#$.$.$.$.$.$                #
#.$.$.$.$.$.############### #
#             $             #
# ######################### #
#             @             #
########################### #
#                           #
#############################
