#################
#####  ##########
##  # *##########
##.$#  * ########
#   @ * * #######
#   #  * * ######
##### * * * #####
###### * * * ####
######  * * * ###
#######  * * * ##
########  * * * #
#########  * *  #
##########  * * #
###########  * ##
############   ##
#############  ##
#################
