###################
######### #########
######## . ########
###   #     #   ###
### $  .$.$.  $ ###
###  $.$.$.$.$  ###
#### .$.$.$.$. ####
### .$.$.$.$.$. ###
##  $.$.$ $.$.$  ##
# . .$.$ @ $.$. . #
##  $.$.$ $.$.$  ##
### .$.$.$.$.$. ###
#### .$.$.$.$. ####
###  $.$.$.$.$  ###
### $  .$.$.  $ ###
###   #     #   ###
######## . ########
######### #########
###################
