###################
#######  .  #######
##   #  . .  #   ##
##  $ $.$.$.$ $  ##
## $ $.$.$.$.$ $ ##
### $.$.$.$.$.$ ###
## $.$.$.$.$.$.$ ##
#  .$.$.$.$.$.$.  #
# .$.$.$. .$.$.$. #
#. .$.$. @ .$.$. .#
# .$.$.$. .$.$.$. #
#  .$.$.$.$.$.$.  #
## $.$.$.$.$.$.$ ##
### $.$.$.$.$.$ ###
## $ $.$.$.$.$ $ ##
##  $ $.$.$.$ $  ##
##   #  . .  #   ##
#######  .  #######
###################
