#############################
###                       ###
### # # # # # # # # # # # ###
#  $.$.$.$.$.$.$.$.$.$.$.$  #
# #.$.$.$.$.$.$.$.$.$.$.$.# #
#  $.$.$.$.$.$.$.$.$.$.$.$  #
# #.$.$.$.$.$.$.$.$.$.$.$.# #
#  $.$.$.$.$.$.$.$.$.$.$.$  #
# #.$.$.$.$.$.$.$.$.$.$.$.# #
#  $.$.$.$.$.$.$.$.$.$.$.$  #
# #.$.$.$.$.$.$.$.$.$.$.$.# #
#  $.$.$.$.# # # #.$.$.$.$  #
# #.$.$.$.$       $.$.$.$.# #
#  $.$.$.$.# # # #.$.$.$.$  #
# #.$.$.$.$   @   $.$.$.$.# #
#  $.$.$.$.# # # #.$.$.$.$  #
# #.$.$.$.$       $.$.$.$.# #
#  $.$.$.$.# # # #.$.$.$.$  #
# #.$.$.$.$.$.$.$.$.$.$.$.# #
#  $.$.$.$.$.$.$.$.$.$.$.$  #
# #.$.$.$.$.$.$.$.$.$.$.$.# #
#  $.$.$.$.$.$.$.$.$.$.$.$  #
# #.$.$.$.$.$.$.$.$.$.$.$.# #
#  $.$.$.$.$.$.$.$.$.$.$.$  #
# #.$.$.$.$.$.$.$.$.$.$.$.# #
#  $.$.$.$.$.$.$.$.$.$.$.$  #
### # # # # # # # # # # # ###
###                       ###
#############################
