#######################
########### ###########
########## . ##########
######### . . #########
####   # .   . #   ####
#### $ $.$.$.$.$ $ ####
####  $.$ $.$ $.$  ####
#####$.$.$.$.$.$.$#####
#### .$.$.$.$.$.$. ####
### .$ $.$.$.$.$ $. ###
## . .$.$.$ $.$.$. . ##
# .  $.$.$ @ $.$.$  . #
## . .$.$.$ $.$.$. . ##
### .$ $.$.$.$.$ $. ###
#### .$.$.$.$.$.$. ####
#####$.$.$.$.$.$.$#####
####  $.$ $.$ $.$  ####
#### $ $.$.$.$.$ $ ####
####   # .   . #   ####
######### . . #########
########## . ##########
########### ###########
#######################
