##################
#######   ########
#######$ $#   ####
#####..   #$ $####
## $ ..##..   ####
##   # $ ..##..###
## $ #$#$# $ ..###
####.. $  $#$# $ #
# $ ..# @  $ #   #
#   # $    #.. $ #
# $ #$#$  $ ..####
###.. $ #$#$# $ ##
###..##.. $ #   ##
####   ..##.. $ ##
####$ $#   ..#####
####   #$ $#######
########   #######
##################
