############################
#########  #################
#########$   #  ############
#########   $#$   #  #######
#######.. $  #   $#$   #####
#### $ ..###.. $  #   $#####
####   #  $ ..###.. $  #####
###   $#$## #  $ ..###..####
### $  # ##$#$## #  $ ..####
######.. $  # ##$#$## #  $ #
### $ ..###.. $  # ##$#$   #
###   #  $ ..###.. $  #   ##
##   $#$## #  . ..###.. $ ##
## $  # ##$#.## #  $ ..#####
#####.. $  # ##.#$## #  $ ##
## $ ..###.. .  # ##$#$   ##
##   #  $ ..###.. $  #   ###
#   $#$## #  $ ..###.. $ ###
# $  # ##$#$## #  $ ..######
####.. $  # ##$#$## #  $ ###
####..###.. $  # ##$#$   ###
#####  $ ..###.. $  #   ####
#####$   #  $ ..###.. $ ####
#####   $#$   #  $ ..#######
#######  #   $#$   #########
############@ #   $#########
#################  #########
############################
