#################
###           ###
### # # # # # ###
#  $.$.$.$.$.$  #
# #.$.$.$.$.$.# #
#  $.$.$.$.$.$  #
# #.$.# # #.$.# #
#  $.$     $.$  #
# #.$.# @ #.$.# #
#  $.$     $.$  #
# #.$.# # #.$.# #
#  $.$.$.$.$.$  #
# #.$.$.$.$.$.# #
#  $.$.$.$.$.$  #
### # # # # # ###
###           ###
#################
