###########################################
##################### #####################
################   # * #   ################
################ #  .$.  # ################
################  $.$.$.$  ################
################# .$.$.$. #################
############ ### .$.$@$.$. ### ############
#######   #   # .$.$ $ $.$. #   #   #######
####### #  .$.   .$.$ $.$.   .$.  # #######
#######  $.$.$. # .$.$.$. # .$.$.$  #######
######## .$ $.$#  $.$.$.$  #$.$ $. ########
####### .$ $ $.# #  .$.  # #.$ $ $. #######
######  $.$ $. #   # * #   # .$ $.$  ######
####### .$.$.$  ### # # ###  $.$.$. #######
######## .$.  #  #   #   #  #  .$. ########
#######   ###  $  #     #  $  ###   #######
##   # . #   #  . #  *  # .  #   # . #   ##
## #  .$.  # ##   # * * #   ## #  .$.  # ##
##  $.$.$.$  # ### *   * ### #  $.$.$.$  ##
### .$.$.$. #     * ### *     # .$.$.$. ###
## .$.$ $.$. #   * # * # *   # .$.$ $.$. ##
# *$.$ $ $.$* # *  #* *#  * # *$.$ $ $.$* #
## .$.$ $.$. #   * # * # *   # .$.$ $.$. ##
### .$.$.$. #     * ### *     # .$.$.$. ###
##  $.$.$.$  # ### *   * ### #  $.$.$.$  ##
## #  .$.  # ##   # * * #   ## #  .$.  # ##
##   # . #   #  . #  *  # .  #   # . #   ##
#######   ###  $  #     #  $  ###   #######
######## .$.  #  #   #   #  #  .$. ########
####### .$.$.$  ### # # ###  $.$.$. #######
######  $.$ $. #   # * #   # .$ $.$  ######
####### .$ $ $.# #  .$.  # #.$ $ $. #######
######## .$ $.$#  $.$.$.$  #$.$ $. ########
#######  $.$.$. # .$.$.$. # .$.$.$  #######
####### #  .$.   .$.$ $.$.   .$.  # #######
#######   #   # .$.$ $ $.$. #   #   #######
############ ### .$.$ $.$. ### ############
################# .$.$.$. #################
################  $.$.$.$  ################
################ #  .$.  # ################
################   # * #   ################
##################### #####################
###########################################
