##############
#######      #
#######* * . #
####### * * ##
###### * *  ##
######  * $ ##
##  ##  ##  ##
## * *  ######
##  * * ######
## * * #######
# . * *#######
# #$   #######
#@  ##########
##############
