#############
#  ##########
#  ######  @#
#  * * *    #
##  * *  *###
##*  *  * ###
## *   * *###
##* *   * ###
## *  *  *###
##.  * *  ###
##  $ * *  ##
#########  ##
#########  ##
#############
