###########
#   ###   #
# #  *  # #
#  *...*$ #
## .$$$. ##
##* $@$ *##
## .$$$. ##
# $*...*  #
# #  *  # #
#   ###   #
###########
