#################
#    .     .    #
# # # # # # # # #
#  * * * * * *  #
# # # # # # # # #
#. * $ * * $ * .#
# # # # # # # # #
#  * * $ $ * *  #
# # # # @ # # # #
#  * * $ $ * *  #
# # # # # # # # #
#. * $ * * $ * .#
# # # # # # # # #
#  * * * * * *  #
# # # # # # # # #
#    .     .    #
#################
