#################
######## ########
#######   #######
###### $.  ######
#####  * *  #####
####  * * *  ####
###  * * * *  ###
##  * * * * *$ ##
#  . * *@* * .  #
## $* * * * *  ##
###  * * * *  ###
####  * * *  ####
#####  * *  #####
######  .$ ######
#######   #######
######## ########
#################
