#####################################
####   ##########   ##########   ####
#### .$##########  $##########  $####
####$. ##########*..####  ####$. ####
# $ $.$$  #### $.$.$*  # $# $ *.*$  #
# ... ...       . @ .        .. ..  #
#  $$.$ $ #$ #  *$.$.$ ####  $*.* $ #
#### .$####  ####..*########## .$####
####$. ##########$  ##########$  ####
####   ##########   ##########   ####
#####################################
