#################
######## ########
#######   #######
######  *  ######
#####  * *  #####
####  * * *  ####
###  *$* *$*  ###
##  * * . * *  ##
#  * * .@. * *  #
##  * * . * *  ##
###  *$* *$*  ###
####  * * *  ####
#####  * *  #####
######  *  ######
#######   #######
######## ########
#################
