#################
######## ########
#######   #######
######  .  ######
#####  * *  #####
#### $*$.$*$ ####
###  * . . *  ###
##  *$.$*$.$*  ##
#  . . *@* . .  #
##  *$.$*$.$*  ##
###  * . . *  ###
#### $*$.$*$ ####
#####  * *  #####
######  .  ######
#######   #######
######## ########
#################
