#############
###   #   ###
###$. # .$###
# $.$.$.$.$ #
# .$ * * $. #
#  .*   *.  #
###$# @ #$###
#  .*   *.  #
# .$ * * $. #
# $.$.$.$.$ #
###$. # .$###
###   #   ###
#############
