#########################
############ ############
##### #####   ##### #####
####   ###  *  ###   ####
###  $ . . $ $ . . $  ###
##  $ * * * * * * * $  ##
###  * * * * * * * *  ###
####. * * * $ * * * .####
#### * * * * * * * * ####
####. * * * . * * * .####
###  * * * * * * * *  ###
##  $ * * *   * * * $  ##
#  * * $ .  @  . $ * *  #
##  $ * * *   * * * $  ##
###  * * * * * * * *  ###
####. * * * . * * * .####
#### * * * * * * * * ####
####. * * * $ * * * .####
###  * * * * * * * *  ###
##  $ * * * * * * * $  ##
###  $ . . $ $ . . $  ###
####   ###  *  ###   ####
##### #####   ##### #####
############ ############
#########################
