#####################
########## ##########
##### ###   ### #####
####   #  *  #   ####
### .$ . $.$ . $. ###
##  $ * * * * * $  ##
###  * * * * * *  ###
####. * * * * * .####
###  * * $ $ * *  ###
##  $ * $...$ * $  ##
#  *.* * .@. * *.*  #
##  $ * $...$ * $  ##
###  * * $ $ * *  ###
####. * * * * * .####
###  * * * * * *  ###
##  $ * * * * * $  ##
### .$ . $.$ . $. ###
####   #  *  #   ####
##### ###   ### #####
########## ##########
#####################
