#################
#################
## ... . . ... ##
##.$$$$$*$$$$$.##
##.$.  . .  .$.##
##.$ $*$*$*$ $.##
## $ * . . * $ ##
##.$.$.$*$.$.$.##
## * * *@* * * ##
##.$.$.$*$.$.$.##
## $ * . . * $ ##
##.$ $*$*$*$ $.##
##.$.  . .  .$.##
##.$$$$$*$$$$$.##
## ... . . ... ##
#################
#################
