#################
######## ########
#######   #######
###### .$. ######
##### .$.$. #####
####  $.$.$  ####
### .$.$.$.$. ###
## .$.$ $ $.$. ##
#  $.$.$@$.$.$  #
## .$.$ $ $.$. ##
### .$.$.$.$. ###
####  $.$.$  ####
##### .$.$. #####
###### .$. ######
#######   #######
######## ########
#################
