#################
######## ########
#######   #######
######  $  ######
##### .* *. #####
#### .$ * $. ####
### .$ *.* $. ###
##  * * $ * *  ##
#  $ *.$@$.* $  #
##  * * $ * *  ##
### .$ *.* $. ###
#### .$ * $. ####
##### .* *. #####
######  $  ######
#######   #######
######## ########
#################
