###############
### ####### ###
##   #####   ##
#  $ . $ . $  #
##  # *#* #  ##
###. *   * .###
### * $.$ * ###
###$# .@. #$###
### * $.$ * ###
###. *   * .###
##  # *#* #  ##
#  $ . $ . $  #
##   #####   ##
### ####### ###
###############
