###########################
###########  *  ###########
########### *#* ###########
######### $ .$. $ #########
########    *#*    ########
#######    * # *    #######
#######.* *# # #* *.#######
##### .$ *   *   * $. #####
####  * # *  *  * # *  ####
###    * *  # #  * *    ###
###$  * * #  #  # * *  $###
#    *#    .$.$.    #*    #
# *.*    # $.$.$ #    *.* #
#*#$###** #.$@$.# **###$#*#
# *.*    # $.$.$ #    *.* #
#    *#    .$.$.    #*    #
###$  * * #  #  # * *  $###
###    * *  # #  * *    ###
####  * # *  *  * # *  ####
##### .$ *   *   * $. #####
#######.* *# # #* *.#######
#######    * # *    #######
########    *#*    ########
######### $ .$. $ #########
########### *#* ###########
###########  *  ###########
###########################
