#################
######## ########
#######   #######
###### .$. ######
##### .$.$. #####
####  $.$.$  ####
### .$#$.$#$. ###
## .$.$   $.$. ##
#  $.$. @ .$.$  #
## .$.$   $.$. ##
### .$#$.$#$. ###
####  $.$.$  ####
##### .$.$. #####
###### .$. ######
#######   #######
######## ########
#################
