#####################
#####################
## ... ..   .. ... ##
##.$$$$$$*$*$$$$$$.##
##.$  . . . . .  $.##
##.$ *$*$*$*$*$* $.##
## $.$. . . . .$.$ ##
##.$ * *$*$*$* * $.##
##.$.$.$. . .$.$.$.##
## * * * *$* * * * ##
## $.$.$.$@$.$.$.$ ##
## * * * *$* * * * ##
##.$.$.$. . .$.$.$.##
##.$ * *$*$*$* * $.##
## $.$. . . . .$.$ ##
##.$ *$*$*$*$*$* $.##
##.$  . . . . .  $.##
##.$$$$$$*$*$$$$$$.##
## ... ..   .. ... ##
#####################
#####################
