###########################################
##################### #####################
#################### # ####################
###################  *  ###################
################## * $ * ##################
################# .  $  . #################
################  # *#* #  ################
########    #  *   * # *   *  #    ########
####### $ * . * * *  #  * * * . * $ #######
#######  # *   * *   *   * *   * #  #######
####### * # * *  ###*#*###  * * # * #######
#######  * # *  # $ .$. $ #  * # *  #######
########. * $  #    *#*    #  $ * .########
#######    * ##    * # *    ## *    #######
####### * *  ##.* *# # #* *.##  * * #######
#######* *  # .$ *   *   * $. #  * *#######
######  *  #  * # *  *  * # *  #  *  ######
#####    *#    * *  # #  * *    #*    #####
#### .# * #$  * * #  #  # * *  $# * #. ####
### *  *  #  *#    .$.$.    #*  #  *  * ###
##    *   *.*    # $.$.$ #    *.*   *    ##
# #*$$###*#$###** #.$@$.# **###$#*###$$*# #
##    *   *.*    # $.$.$ #    *.*   *    ##
### *  *  #  *#    .$.$.    #*  #  *  * ###
#### .# * #$  * * #  #  # * *  $# * #. ####
#####    *#    * *  # #  * *    #*    #####
######  *  #  * # *  *  * # *  #  *  ######
#######* *  # .$ *   *   * $. #  * *#######
####### * *  ##.* *# # #* *.##  * * #######
#######    * ##    * # *    ## *    #######
########. * $  #    *#*    #  $ * .########
#######  * # *  # $ .$. $ #  * # *  #######
####### * # * *  ###*#*###  * * # * #######
#######  # *   * *   *   * *   * #  #######
####### $ * . * * *  #  * * * . * $ #######
########    #  *   * # *   *  #    ########
################  # *#* #  ################
################# .  $  . #################
################## * $ * ##################
###################  *  ###################
#################### # ####################
##################### #####################
###########################################
