#####################
########## ##########
######### # #########
######## # # ########
####### #   # #######
###### #  *  # ######
##### # .$.$. # #####
#### # .$ # $. # ####
### # .$ # # $. # ###
## #  $ # # # $  # ##
# #  *.# # # #.*  # #
## #  $ # # # $  # ##
### # .$ # # $. # ###
#### # .$ # $. # ####
##### # .$.$. # #####
###### #  *  # ######
####### #   # #######
######## #@# ########
######### # #########
########## ##########
#####################
