#####################
#########   #########
######### $ #########
######## $.$ ########
######  $.*.$  ######
###### $ *.* $ ######
####  $ *.*.* $  ####
#### $ *.* *.* $ ####
### $ *.*.$.*.* $ ###
#  $.*.*.$ $.*.*.$  #
# $.*.* $   $ *.*.$ #
#  $.*.*.$ $.*.*.$  #
### $ *.*.$.*.* $ ###
#### $ *.* *.* $ ####
####  $ *.*.* $  ####
###### $ *.* $ ######
######  $.*.$  ######
######## $.$ ########
######### $ #########
######### @ #########
#####################
