##############
#    ## ######
#.$$. ## #####
# .$$. ## ####
## .$$. ## ###
### .$$. ## ##
# ## .$$. ## #
## ## .$$. ###
### ## .$$. ##
#### ## .$$. #
##### ## .$$.#
###### ## @  #
##############
