#################
#########  ######
#########  ######
######### .######
#######.$.$  ####
######.$.$*   ###
#####.$.$*  *$ ##
####.$.$*  *$.$.#
###.$.$*  *$.$.##
##.$.$*  *$.$.###
#.$.$*  *$.$.####
## $*  *$.$.#####
###   *$.$.######
####@ $.$.#######
######. #########
######  #########
######  #########
#################
