#####################
################  ###
#############  $*. ##
##########  $*.     #
#######  $*.   .*$  #
####  $*.   .*$  ####
# @$*.   .*$  #######
#     .*$  ##########
## .*$  #############
###  ################
#####################
