#######################
##############  #######
###########  $*.  #####
########  $*.     #####
#####  $*.   ### $#####
##  $*.   #### # * ####
##     ####    # . ####
# . ####   #   ## $####
# * #   # # # # # * ###
##$ ##   #   #  # . ###
## . #  # # # # ## $###
## * # #   #   # # * ##
###$ ## # # # #  # . ##
### . #  #   #   ## $##
### * # # # # #   # * #
####$ ##   #   #### . #
#### . #    ####     ##
#### * # ####   .*$  ##
#####$ ###   .*$  #####
#####     .*$  ########
#####  .*$  ###########
#######@ ##############
#######################
