##########################
###       ################
### ##### .  #############
### #   #* .  #####      #
### # $   . #       #### #
### ## ###$##########  # #
###  # ## $          $ # #
#### #  # # #####  ##  # #
#### #  #   ##  ##### ## #
#### # ###$######   # *  #
#### # # #.#   .$ #$$. .##
#### # # # .$ .##   # . ##
###  # ###  ##$ ### ##  ##
##  ## ### $##  ### #  ###
## . #   ##. $. # # # ####
##. .$$# $.   #.# # # ####
#  * #   ######$### # ####
# ## #####  ##   #  # ####
# #  ##  ##### # #  # ####
# # $          $ ## #  ###
# #  ##########$### ## ###
# ####   @   # .   $ # ###
#      #####  . *#   # ###
#############  . ##### ###
################       ###
##########################
