##################
#############  ###
###########.$.   #
##########.$.$$. #
#########.$.$$.$##
########.$.$$.$.##
#######.$.$$.$.###
######.$.$$.$.####
#####.$.$$.$.#####
####.$.$$.$.######
###.$.$$.$.#######
##.$.$$.$.########
#.$.$$.$.#########
## $$.$.##########
##@  $.###########
#####.############
##################
