##################
#############  ###
############  @  #
###########  *$ .#
##########  **  ##
#########  **  ###
########  **  ####
#######  **  #####
######  **  ######
#####  **  #######
####  **  ########
###  **  #########
##  **  ##########
#  **  ###########
# **  ############
#  ###############
##################
