#############
###       ###
### # # # ###
#  $.$.$.$  #
# #.$.$.$.# #
#  $.# #.$  #
# #.$ @ $.# #
#  $.# #.$  #
# #.$.$.$.# #
#  $.$.$.$  #
### # # # ###
###       ###
#############
