################
###########   ##
########### # ##
#             ##
# # $#######$$##
# #  *.....#  ##
# #$ #.***.*  ##
# #  #.....#  ##
# #  ####*###$##
# #         $  #
# $ $ $ $ $ $ @#
##  ############
################
