################
##......########
##......########
##......########
##      ########
##      ########
##### ##########
##  $    $ $ $ #
#    $ #$#   # #
#@#$ $ $  ##   #
### $# #  #### #
###  $ $  #    #
### $# $ #  $  #
###    $   $ $ #
###  ###########
################
