################
#...############
#....$ $     ###
#..*. $   #  ###
#.*..### ## ####
#....# $  #    #
###### #$ #$#$ #
###@$  $  # $  #
####      #    #
###########$ # #
####     $   $ #
#### # # # $## #
####   $   $ $ #
###########    #
################
