################
######    ######
#   #  #  #   ##
# $$  $#$#  $  #
#  #.#...  $ $ #
#   .....@# $  #
# $#.##*#  $$$ #
##  ....#$ #   #
####.#...  #####
### $ $#$# #####
### $#   $ #####
###    #   #####
################
