###############
###.........###
###.........###
##########$$ ##
#     $  $ $ ##
# @##$ $  $  ##
# $#  ## ### ##
#    $$ $   $ #
####$  $  #$$ #
####  $#      #
####     ######
###############
