###############
###############
#######  ######
#####  $ ######
####  $.$  ####
#### $.*.$  ###
##  $.*.*.$ ###
## $.*.*.*.$ ##
### $.*.*.$  ##
###  $.*.$ ####
####  $.$  ####
###### $  #####
###### @#######
###############
###############
