################
#   #########  #
#              #
## ##########  #
## # * . * ## ##
## #  * *  ## ##
## # * * * ## ##
## #  * *  ## ##
## # * * * ## ##
## #  * *  ## ##
## # * * *     #
##$#  * *  #   #
##@  * * * #  ##
################
