##################
#       ##       #
#    $   $       #
#   * *    * *   #
#  * *  $   *.*  #
#   *.* ## * *.  #
#  *.*  ##  *.* @#
#   *.* $  * *   #
#  * *      * *  #
#        $   $   #
#       ##       #
##################
