#######################
#     #  ##############
#     .    ####  ######
# # #####$   $   ######
# # #. .#   ##  $#  ###
# # #. .###$###  . $###
# # ##  ##    $  $   ##
# #  #  #.  ### $#$ ###
#   ##  ## ##.#  $   ##
# .  #  #.  # #### $ ##
#. . #  ##     $ $ # @#
# . ##  $   #   $  $ ##
#. . #   $###$ ########
# .  ###      #########
###  ..################
#######################
