#######################
#  ####################
#    #                #
#.#  #       $#$#$#$$ #
### ##  ## # $ $ $  # #
# # ##  #  # # $ # $  #
#   ##  ## # $ # $ #$ #
#    #     #          #
## #$#  ## # ##########
## # ##  # ###      ###
## #     #     $   @###
## # # #.#    ## $ ####
## # # # # ...#  #..###
##     ### .#.#  ##.###
## ### #   ...  ##..###
##  #  # *#  #      ###
## ##$ #. .         ###
##     ################
##  ###################
#######################
