####################
########   #########
########   #########
######## $ $ $ $ ###
########  $ $    ###
###   ## $ $ $ $   #
##    .#   ##### $ #
## ###    ##...# # #
## ##    ## . .# $ #
## #    ##  ..## # #
## #   ##.  .##  $ #
##    ##. . ## $   #
##   ##. . ##  # ###
##  ##  . ##  $  ###
#  ##    ##  $#  ###
# ...   ##     $ ###
##. .  ##  $ #$#$###
##... ## $ # $ $ ###
#######@         ###
####################
