###################
#######           #
#######   $  $ $  #
#####   $   $ $ $ #
#####  ## $ # ### #
#####  #  ### # # #
##### ##$    $  # #
#####  $  # $   # #
##  #     ####$   #
##    $ #  $ #   ##
# $ $ #$#  # $  ###
#...#   ####   ####
#.#.## ##...$ #####
#.#.#  #....  #####
#.+.   #...########
###################
