##################
####  ####   #####
# $  $     $ #####
# #   # ### #   ##
#  $   $ # $$ $ ##
###  ## $@$     ##
###$ ##  # $$ $$ #
###    $  ## ##  #
#### #$##  ...# ##
##  ..*.*..##.# ##
## #..*.....*.# ##
##   ########   ##
##################
