#################
###  ############
###  ############
###  ###..   ####
### ####..##$####
###  $ $.*     ##
### #$ #*.# $# ##
###$#  #..#  # ##
#   #$ #*.# $# ##
# # #  $..#  # ##
# #$#$ #..$  #  #
#   #  #..#   # #
# #@# $#*.#$# # #
#  $#  #..#   # #
##   $ $ $ ###  #
#####   #      ##
#################
