###############
#   ##   ######
# $   $ $ #   #
# $ #  .$ #   #
###  ##.#  $ ##
# ##$##.###. ##
#   *.......$##
#    ##.##   ##
##$####.#######
#  $ # . #   ##
#  #  **$    ##
#  $ # @ # $ ##
# $   #####  ##
###   #########
###############
