###############
#   #     #   #
#  . * *@*  . #
##$##  *$ ##$##
#    #   # $  #
#  #*#####.#  #
# $* #   # .$ #
##   #*.$#   ##
####     * ####
##  . * * $. ##
## ## ###.## ##
##    ###    ##
###############
