####################
##   ###   #########
#  #  ##      $ ####
# $$   ##*###  $ ###
#  # $ #...  #  $ ##
# $# # # *$# ##  $ #
#    $ #...#   #$  #
##  #####.## $    ##
# .#...##.### ##  ##
# *.*....*.. $######
# .#. .##.### ######
## # ####.#       ##
## $  ###*#$#$$ $ ##
#  ##   $@$    ## ##
# $ $ #$### # $   ##
#     #     ##    ##
####################
