#################
######     ######
#####  # #  #####
####  #   #  ####
#### #  *  # ####
###  # * * #  ###
##  ##$.#.$##  ##
#  # $  #  $ #  #
# # *  *.* .* # #
#  $ ##. .## $  #
# # *. *.*  * # #
#  # $  #  $ #  #
##  ##$.#.$##  ##
###  # * * #  ###
#### #  *  # ####
####  # @ #  ####
#####  # #  #####
######     ######
#################
