###############
### .*.*.$  ###
#   * $ * $  ##
#  $.$.*.*.$  #
# $ * *@* * $ #
#  $.*.*.$.$  #
##  $ * $ *   #
###  $.*.*. ###
###############
