#####
#+  #
#$$*#
#  .#
#   #
#   #
#   #
#####
