#######
# .   #
# $$  #
#   .@#
#######
