#####
#.$@#
###*#
##*##
#####
#####
#####
#####
#####
