#####
# @.#
# $ #
#   #
# $.#
#   #
#####
