##########
#      . #
#        #
#     $  #
#.*      #
#*$ $.   #
#     $  #
##*@    .#
##########
