#####
#  .#
# $ #
# $@#
###.#
#####
