#####
#@  #
# $$#
## .#
#  ##
#  .#
##*##
#####
