######
# . @#
# $  #
# $  #
# .  #
######
