##########
#        #
#  $ .  .#
#  $.$ $ #
#   +    #
##########
