#########
##*     #
#       #
##*#   $#
###.  $+#
#########
