########
#@     #
# $$ $ #
#.  .. #
########
