######
#    #
# $. #
#@   #
# $.$#
#   .#
######
