########
#  *#  #
#   .$.#
# $ .  #
#  @  $#
#      #
########
