#####
#.$ #
#.$@#
#   #
#   #
#####
