############
# . $ @ *###
#  *$.  ####
# $      ###
# .      ###
############
