######
##@ .#
#  $ #
#    #
#  * #
#  $ #
#   .#
######
