########
#@$ .*##
# $ ####
#   .###
########
