############
##       . #
#   .   *  #
#   * $$   #
#   $ @  * #
#    .     #
############
