###########
#@$    .  #
# $*    * #
#     .   #
# .  $.$  #
###. $    #
####      #
###.  $   #
###########
