#########
#@      #
#.$ $ #*#
#   . ###
#########
