#########
#@ .    #
# $ . $ #
#   $.  #
# $.  $ #
# .     #
#########
