#######
#    .#
#$  $ #
#     #
#.   @#
#   $ #
#.$ . #
#######
