######
##.$ #
#  ..#
#    #
#.   #
#    #
#$$$ #
#   @#
######
