#####
### #
##  #
##$ #
# . #
# * #
#   #
#@* #
#####
