###########
#@.     $ #
#     $ $ #
# $$   .  #
#  * .    #
# .#.     #
###########
