#######
## .  #
#    .#
# $   #
#  $$.#
# $.  #
# @   #
#######
