#########
#*  . ..#
#      $#
#     $@#
#    # $#
#. $ ##.#
#  $   ##
#      ##
#########
