######
# @###
# $.##
# $###
# $.##
#  . #
#    #
#.$  #
######
