#########
#     @ #
# . * $ #
#       #
# *$$   #
#.   .  #
#########
