######
# .  #
# $  #
#@   #
# .  #
# $$ #
#.   #
######
