############
#  .    ####
# $ $   .###
#    $  ##.#
#  @ .  #  #
#   .$ .$$$#
#####    . #
############
