#######
#@*#  #
# .   #
# *$$ #
#     #
#  $  #
#     #
#   ..#
#######
