########
#    . #
#@   $ #
#.$. $ #
#      #
########
