############
#.    *@$  #
###  # $ $ #
##     #.  #
## $ *##.###
## .########
############
