############
#** $ . . @#
##. $      #
###      $ #
######     #
############
