#####
# @##
#  ##
# ..#
# $ #
# $$#
#.  #
#####
