########
##   .@#
#      #
#    $$#
# *.  .#
# $  $.#
#      #
########
