#######
#@    #
#$$   #
#.    #
#.##*##
#######
