#####
# $.#
# $##
#  .#
#   #
# $ #
#  .#
#  @#
#####
