#######
#.    #
#  @$ #
#     #
#  $  #
# *.  #
# *   #
#######
