#########
# *@ #*.#
#   .  *#
#  $    #
#    .$ #
# $     #
#       #
#       #
#########
