#########
# *#    #
#       #
# $$  . #
#@$    *#
# ..    #
#########
