######
# $. #
#@$. #
#    #
######
