############
# @        #
#* $   . . #
##.        #
###      * #
#*       $ #
#  $ # $.  #
#. $ ####* #
############
