##########
#       .#
###  $ $$#
#*#.#@.  #
#####    #
##########
