#########
#     . #
#$.   $.#
#.  $ *.#
# $     #
#     $ #
#       #
#     @##
#########
