#########
#@  $.*##
#  .  *##
#  $    #
#    $  #
#    . ##
#########
