#####
# . #
# $ #
#   #
#.$ #
#@  #
#####
