#####
# #*#
# #.#
#   #
#   #
###$#
#.$@#
#####
