########
#      #
#$    @#
#      #
#.*. $ #
########
