###########
#   .#  ###
# $   .$.##
#        .#
#  .   $$##
# $      ##
# $     .##
#. @$  #*##
###########
