##########
#.   #####
#  $ .####
#    $*###
#@  . ##.#
#  $  *#$#
#        #
##########
