########
#   .  #
# $@   #
#  $ * #
#.     #
########
