###########
##        #
##$#####  #
## $.### ##
#  .* #* *#
#     #.$@#
###########
