###########
##   ##   #
# $ .*  *.#
#  $ .  $@#
# #  $    #
#.#       #
###########
