######
#  . #
#  $ #
# @$ #
# .  #
######
