########
##     #
#.$.$  #
#      #
#$$@   #
# *  . #
#.#    #
########
