############
#  .     ###
# #  $$    #
#   . $.   #
#   $    $$#
#      ..@ #
# *     $ .#
#  $  .   .#
############
