######
#    #
# *###
#@$ .#
######
