#####
#   #
# * #
#  .#
#   #
# $$#
#  +#
#####
