###########
# *     @##
# *..     #
#  $$ $   #
#  .      #
###########
