######
#    #
# $* #
# .  #
# $  #
#@.  #
######
