###########
###.   .$ #
####$   $ #
####.#  $+#
###########
