############
# @  .    *#
#  $   .$$.#
#        ###
#     .$ ###
#       ####
# # $   .#*#
############
