###########
#         #
# ** @$. $#
#        .#
###########
