###########
# $.$  .###
#       #*#
# @  ..####
# $.#  *###
#  $#  $ ##
#        ##
###########
