#######
#######
##   ##
#. . .#
#$ $*$#
#   @ #
#######
