#######
#     #
# * $ #
# @  .#
#######
