############
#.     @ . #
#       $  #
# $* *$    #
#.         #
#.         #
#$   $# *.$#
#     #   .#
############
