##########
#@   .   #
#  $ .   #
#   . $  #
#.$$$ .  #
#      ###
##########
