#########
# *#    #
# ##$@  #
#       #
# *    .#
# $$. # #
#.      #
#      *#
#########
