##########
#        #
##@      #
## $.  $ #
#* . $.  #
#  .  $  #
##########
