######
#    #
#$ $ #
#..@ #
######
