######
#    #
# $ .#
#  @.#
#  ###
# $**#
#  ###
######
######
