########
#      #
# $ $ *#
#  . . #
#    @ #
########
