##########
###.     #
#* .$@$$ #
#.       #
##########
