###########
####.   $ #
###   $ * #
##    .   #
#   $ ##$ #
# . .  .$@#
###########
