########
#     ##
#     ##
# . $  #
#  *$@ #
# .$  ##
# $ .  #
#   .  #
########
