#########
#   .   #
# $$    #
# . $$. #
#@ .    #
#########
