#########
#  .    #
# $  $$ #
#   @.. #
#    .$ #
#########
