#########
#.$@    #
#.   $  #
# $   #.#
#     *##
#########
