#######
#     #
# @$ $#
#   ..#
#######
