##########
#  .@  $ #
#      * #
#   .  . #
# $.  $  #
# $ $  . #
#        #
##########
