############
#..# .     #
#$ $ $  $ .#
#    @     #
############
