##########
#    +   #
#   $$ $ #
# .#.. $ #
##########
