#####
#  @#
#.$ #
#   #
# $ #
#$. #
#  .#
#####
