#########
####*.$@#
###   $*#
### ##.##
### #*###
#########
#########
