#######
#     #
##$$$@#
##..  #
###  .#
#######
