###########
#####.. $@#
##*###  $ #
###*##    #
###########
