############
#+$     ####
#$$   $  .##
#   $  .  ##
#       .$ #
#.$   $.  $#
#  .     #.#
# .      ###
############
