#########
# *#   @#
#  # .$ #
#  #..  #
#       #
#  $$ $.#
#       #
#########
