########
#      #
#    $ #
# $  * #
#.@$   #
# .$   #
# . .  #
########
