#########
#########
#########
#####*###
#  ##.#.#
#   .   #
#   $$$$#
#.   .$@#
#########
