#########
#     . #
# $     #
#  *    #
#  +  $ #
# $  .  #
#      ##
# *  ##*#
#########
