##########
#####. $@#
###### * #
###*#. $ #
##########
