########
#   #*@#
###  * #
##.  $ #
########
