###########
#   @     #
#   $ $.$ #
# $   .#  #
#   *.#.  #
###########
