########
# @.  ##
#$$  ###
#. $.###
##   ###
#. $ ###
##.$ ###
#### ###
########
