#######
#   #.#
#   * #
#   @ #
#.$  $#
# $.  #
#######
