#######
#@$.###
#$ #*##
#.#####
#######
#####*#
####*##
#######
#######
