########
# $  ..#
# . .$##
# $    #
# @    #
# $    #
#    *##
########
