#########
#       #
# * * $ #
#     ..#
#     $ #
# ##  $ #
#     .@#
#  #*   #
#########
