#########
#      @#
#  ** $ #
#.      #
#########
