###########
#. .      #
# *  $ $$ #
#  @.     #
###########
