##########
# *      #
# $@   $ #
#     .  #
#    $.. #
##########
