########
#      #
# $  $ #
#..$+  #
# . $  #
#      #
########
