######
#  . #
# $$ #
#+   #
######
