#####
# $.#
# * #
#  @#
#####
