##########
###*#. $ #
###*##  @#
####.  $ #
##########
