#######
###  .#
#.  $ #
#     #
#$    #
# * $ #
#+    #
#######
