###########
#@* #######
#$$  .#####
#.*########
###########
