#######
#+$  ##
#$   ##
#.    #
####*##
###*###
#######
#######
