###########
#     #.$@#
#  $    $*#
#        .#
#.$ *     #
# .##   ###
###########
