##########
#     ## #
#.  $   @#
#     *  #
# $.     #
##$      #
#.  $ .$.#
##########
