#######
#    ##
#    *#
# .. ##
# $ . #
#@$$  #
#     #
#######
