######
#   @#
#  * #
#  * #
#  . #
# $  #
#    #
######
