#####
#   #
#$$.#
# $ #
#.@ #
#   #
#  .#
#  ##
#####
