#######
###  ##
#### ##
#*#  .#
###  ##
#   $*#
#  .$@#
#######
