########
# *    #
#@$    #
#.     #
# $  . #
#  . $ #
# $ .  #
########
