############
#     . . *#
#      $$ ##
#.   #.    #
#    ##    #
#        $ #
#$$$$.     #
#@* .  .   #
############
