######
##.$@#
###*$#
#### #
#*##.#
######
######
######
######
