############
#.         #
##$   $$$  #
## .  .  .@#
############
