#####
#   #
# $.#
# $+#
#####
