############
#..*      @#
#        $$#
#   * #  #.#
#$ $    $ ##
#         ##
#       . .#
############
