##########
#   . $ ##
#     $.*#
# $   +  #
##########
