######
###.##
### .#
###  #
###$$#
#. $@#
######
