#####
#  @#
#   #
# $ #
# . #
# $.#
#####
