###########
#    @    #
#   $ $$$ #
#    $.. ##
#       .##
#  .   . ##
# . $$   ##
#  . .$ ###
###########
