############
#  ##*##.  #
# $  #.##$ #
# +    #   #
#          #
# $. *$#   #
# $     .  #
############
