######
#    #
#* $ #
#.  .#
#  $ #
#  @ #
######
