#######
###.$ #
#.  . #
#     #
#$ $  #
#@*   #
#######
