##########
#      @ #
#$       #
#  . $  .#
# $ * # *#
#.      ##
##########
