#########
#       #
# *$$   #
#  .  * #
# .  @  #
#   # *##
#########
