###########
#.  .  $.##
# $     #*#
#      ####
#@$  .  .##
#  $   $ *#
#         #
###########
