#########
#@$    .#
#$      #
#.$     #
#.  *##*#
# * ##  #
#   #   #
#      ##
#########
