#######
#    .#
# $ $ #
# .  @#
#######
