############
#        . #
#  $  *$ $ #
#    @*    #
# .  .     #
#   $.     #
### $.     #
############
