#####
#. +#
#$$ #
#   #
#####
