#####
#@* #
#   #
# $ #
# . #
# $ #
#.  #
#####
