#########
#  .    #
#     * #
#.  @   #
# $$$*  #
#      .#
#########
