#########
#..  $ ##
#   $.$ #
#.    $@#
#       #
#########
