###########
#####.  $ #
#*        #
#         #
#    $ .  #
#     .*$ #
#  ##  *@*#
###########
