#######
#.    #
#$$$ @#
#    ##
#     #
#..*# #
#* #  #
##   ##
#######
