#####
#   #
#  $#
#@* #
# #.#
#####
