#########
#########
# $.* ..#
#       #
#    $  #
#   . $$#
####  @ #
#########
