##########
# @      #
# $ ..$ *#
# $  .   #
##########
