###########
#      .+ #
#  $  ..$ #
#.        #
#.$  $$$  #
###       #
###########
