#########
#  @ .  #
# $ $ . #
#  .    #
###  * $#
###   $ #
###   $ #
###   ..#
#########
