##########
# $.    *#
#        #
# $.   $ #
#   @   .#
##########
