######
#   .#
#    #
# .$@#
#   $#
# $. #
#    #
######
