#######
##*.$@#
### $$#
### ..#
###  ##
#######
#######
