######
#. $@#
##  $#
#   .#
######
