#########
#########
#.*######
# #######
#$ ###*##
#@$.##*##
#########
