############
#  $    .###
#         ##
# $    * $@#
# .     .#*#
############
