######
#    #
# *. #
#  * #
#  $ #
#   @#
######
