########
#  @   #
#$$*   #
#  #.$ #
#      #
#..    #
########
