############
#      .  ##
# $$$  #  *#
#. .@     ##
############
