#########
# .$    #
#     *@#
####. $ #
#########
