########
###### #
####   #
#.     #
#      #
# $ . ##
#$* $  #
#@$.  .#
########
