#########
#      .#
# $ . $$#
# @$    #
#     . #
#.$  ##.#
#    ####
#########
