##########
#      $+#
# $   .$$#
# .    #.#
##########
