###########
#     .   #
# @* $$   #
# $. .    #
###########
