##########
#.@ .   .#
#$.$$    #
#     $  #
#        #
##########
