##########
#.       #
#  $ $ . #
#  @  . .#
#. .$  $$#
# $      #
# $ .#####
#   ######
##########
