########
#     .#
#. $ $ #
#      #
#      #
#$#    #
# $ $ .#
#.   + #
########
