#########
#    $.+#
#$ $ $  #
#       #
#.   .  #
#########
