#######
#.@  ##
# $ $.#
#   ###
#######
