##########
#     @#*#
#     . .#
#    $.$$#
#        #
##########
