############
#          #
#  $*   $ @#
#    $ #  ##
#  .       #
# *# . .#*##
############
