########
#  $.  #
#.  $  #
#   $  #
# @ . ##
########
