#####
# . #
# $ #
#   #
# $ #
#.  #
#@* #
#####
