#######
# $ .##
#@* . #
#.  $ #
# $   #
#     #
#######
