##########
#     $. #
#   $ .  #
#*#.  .$ #
### $ @  #
##   . $ #
#* #     #
##       #
##########
