##########
#@       #
#  $    .#
# $    $ #
#.*.  #  #
##########
