########
########
###   ##
#     ##
#    .##
# .$$*##
#  .$@*#
########
