#######
#     #
#  .  #
##.$$ #
##.@$ #
#######
