#######
#     #
# *.$ #
# *   #
#@  $ #
#     #
#     #
# * .##
#######
