######
######
######
######
##*#.#
###. #
#* $$#
#  @ #
######
