######
# * ##
# . .#
# $  #
#  $@#
#    #
######
