#########
#  .  $ #
# *.# $ #
# $ .   #
#  @    #
#########
