###########
#  #      #
#@$.$ $  *#
# .    .  #
###########
