########
#      #
#  $.  #
#     @#
#  $$  #
##  *. #
#.   $.#
########
