###########
########.##
########$.#
#######.$$#
#*####. $@#
###########
