########
#     ##
#. $   #
#$ . $ #
#@   . #
########
