######
#    #
#$ $ #
#.   #
# .. #
## $ #
#* @ #
#### #
######
