############
#  @    .###
#.  $   .*##
#   $*  ####
#      #####
#  $   #####
#     #*##*#
############
