#######
#     #
#   $ #
# . *@#
#######
