#####
#   #
#@$ #
# * #
#.  #
#   #
#  ##
##*##
#####
