#######
##.#*@#
# $  *#
#     #
#     #
#######
