#####
##  #
## *#
#.$@#
#####
