#######
#.    #
#   $ #
# @ $.#
#######
