##########
##########
##########
#*##*#####
##########
######. .#
##*##* $$#
#####. $@#
##########
