##########
# .  $ *##
#   .$  ##
#       .#
#  $ .   #
#   @$  $#
#    .   #
##########
