#########
#   . $ #
#  $ $. #
#    .  #
#$ * ####
#.  #####
##@######
######*##
#########
