############
#        ###
#.$$$ . ####
#@ . $  #*##
#  . .     #
#   #$   # #
#  $ .     #
############
