#####
# + #
# $ #
#   #
#   #
# $.#
#####
