######
#    #
#.$  #
#  . #
#    #
#    #
#*$  #
#@*  #
######
