#######
###   #
#.#  *#
#     #
#$. $ #
#@$.###
#######
