########
#   +  #
##$* $ #
##.    #
########
