############
#    . $  .#
#  @  $   $#
#      $ $.#
#      . *.#
#          #
############
