#########
#  .  .##
# $$ $  #
#.   @  #
#########
