#########
##      #
#* .  $ #
# @ $  .#
# .   $ #
#########
