########
#     .#
# .   @#
# $  $ #
#  $.  #
########
