#######
#  @  #
#$$$  #
#...  #
#     #
#######
