##########
#+$ ..####
#$.  $#  #
#   $  $ #
## $     #
### *   .#
###      #
###    . #
##########
