#######
#   .##
# $  ##
# *  ##
# @ #*#
# $ .##
#######
