#########
#   *@  #
# .   $ #
#  $.   #
#########
