######
#   .#
# $  #
#  @ #
# *  #
######
