#########
# @     #
#$ *    #
#.$     #
#..$  ###
#########
