#####
# . #
#@$ #
#  ##
# $.#
#####
