############
#.       $ #
#        . #
#      #*$ #
#   $. + $ #
############
