##########
# $  *.# #
#        #
##*.$    #
#   #    #
# $ $    #
# @.#.   #
##########
