#####
#   #
#.$ #
#@* #
# # #
#####
