###########
#      @ ##
# $ $ .####
#     .##*#
# $.  *#*##
#     #####
###########
