##########
#   .    #
# $  .   #
#   $$ $ #
#  .   + #
##########
