#####
#   #
# $ #
#  .#
# *@#
#####
