############
#    $    .#
# $  @$$  ##
# .   ..   #
############
