##########
##    @  #
#*   $   #
##   $   #
### *    #
###  .   #
#*.  . $ #
##########
