#########
#@$ .   #
# $$    #
# .##$  #
# *##.* #
######. #
######  #
######  #
#########
