########
# .    #
#   $$+#
#   $  #
###    #
#####  #
####.  #
##*##* #
########
