#####
#@. #
# $ #
#   #
# *.#
# $ #
#   #
##  #
#####
