#####
# $.#
#   #
#  $#
#   #
# *.#
#  @#
#   #
#####
