##########
#      ###
# ..$  ###
#.    ####
#$$*# ####
#@$ . ####
##########
