#########
#       #
# . ..$ #
# $     #
#  $.$* #
#  @    #
#########
