#######
#     #
#   *$#
# ..  #
# $$  #
#@   .#
#######
