###########
# $  .    #
# $     $ #
#    @  . #
# *##.$   #
#.*###    #
###########
