########
#     .#
#.$ $  #
# $  $@#
#   .  #
# #.   #
########
