#########
# *#  @ #
# $   $ #
# $ .  .#
#  .    #
#########
