#####
#   #
#  @#
# $$#
#   #
#  .#
#  *#
#  .#
#####
