##########
#     . @#
#.   $$$$#
### #    #
###   .# #
#*# ####.#
##########
