##########
## $ . $+#
#     $ ##
# .   $.##
##########
