############
############
#.#######*##
#$$.#####*##
#@$.########
############
