######
#  ..#
#    #
# .$ #
#  $@#
# $  #
#    #
######
