#######
# .$@.#
# $  .#
#    $#
#     #
#######
