##########
#   . ####
# +$ .####
# $ $ ####
#  . #.###
#    *  ##
#$ $  $  #
#.       #
##########
