#######
###   #
# $.  #
#.*   #
# $ $ #
# @   #
#     #
# $. .#
#######
