############
#.     $.###
## $    #..#
#     .*$  #
##   $   . #
#      .#$ #
#   $ $ . $#
# @   ##   #
############
