############
# $.    @  #
#    $ * * #
#  $   . $ #
#          #
# .##  .   #
############
