##########
# .    ###
#     .###
# *      #
#   $    #
#    .   #
#####$$$ #
####*+$ .#
##########
