#########
#      @#
#$   $  #
#    . .#
#  . $$ #
#.#   $.#
#########
