###########
#+.   $ .##
# $    .  #
# .$ $ $  #
#   $  .  #
#         #
###########
