#######
##   @#
#.$$  #
#.    #
#     #
#$    #
#. *  #
#######
