#####
###.#
##  #
#@$$#
#.  #
#####
