##########
#        #
# ##  $ *#
#  #     #
#   .   .#
#..      #
#$$.$   $#
#+$      #
##########
