#########
#@$ .####
#$$    ##
#   #* ##
#   #####
#..######
######*##
#########
