#########
##     @#
# *$  $ #
#  .# . #
#########
