######
#  *##
#$ ###
#    #
#.$@ #
#    #
#  . #
######
