##########
# .      #
# $* $. @#
#  .   $ #
##########
