######
#@   #
# $$.#
#.   #
######
