#########
# .   $ #
# *  *  #
# .   $ #
#  @    #
#########
