#########
#     *@#
# $.#  $#
#  ###* #
#   ###.#
######*##
#########
#########
