######
##   #
#*.$@#
#    #
######
