############
#.  $   .  #
#  .   @*$ #
####. $$   #
#       $  #
#    .     #
#    $  .  #
############
