#########
#       #
# @     #
#    .  #
#  $   $#
## $ .$ #
##.. $ .#
#########
