##########
##    #..#
#      $ #
#    # $*#
#    . $@#
##########
