######
##.$@#
###*$#
#### #
#    #
####.#
######
