######
#.  .#
# @$$#
#    #
######
