#####
# . #
#.$ #
# $ #
#@  #
#####
