#########
#.    ###
#$   ####
#@$   * #
#*#.    #
#########
