######
###*.#
###  #
###  #
#### #
###* #
### $#
#. $@#
######
