#######
# +  .#
#  $ $#
#     #
#######
