###########
#@     ####
#$$   $*###
#   . .####
#. .$ #####
########*##
###*#######
###########
