########
##     #
## .   #
# .$@$ #
#   $  #
# $. $ #
#   .  #
#  .####
########
