########
# *   .#
#      #
#  @$. #
# .  $ #
# $  $ #
# .    #
########
