#######
#####.#
####  #
####*$#
##. $@#
#######
