#####
#   #
#.$ #
#   #
#   #
# $.#
#.$@#
#   #
#####
