############
#       .###
#. $     ###
# @$  $* ###
#    .   *##
############
