#######
#    .#
#.$$.$#
# @   #
#    ##
#  $ .#
#######
