#########
# $  .###
#+$   ###
# $   .##
#########
