#########
#.$     #
##@ * $ #
#   .   #
#########
