######
###@.#
#    #
# $* #
#. $ #
#    #
######
