#######
#     #
# $.  #
# ..$ #
#.$ $@#
#$    #
#     #
##.   #
#######
