#######
#   @ #
# *.$ #
#     #
#######
