#########
#   .####
# $ .*###
# $$ ####
# @  .*##
#    ####
#########
