############
#*###.   $@#
#####   $ $#
#####.     #
###*# $   .#
#####    .##
############
