########
#    . #
# * $  #
### @$.#
###    #
########
