########
# @    #
# $   $#
#      #
#   .*.#
#    ###
#  *#*##
########
