######
#  .@#
# $  #
#.$  #
#    #
#.$  #
#    #
######
