############
#*##*  @   #
##### $.$  #
####.      #
############
