##########
#####  #*#
#####  $@#
#####   $#
####*.  .#
#*#    ###
##########
