##########
#*@      #
#.$      #
#$    $ .#
#  $     #
#  $   . #
#.#.##   #
###*##   #
##########
