############
# .   $    #
# $  .# .$ #
#@$        #
# .   $ .  #
############
