#######
#     #
#$.   #
# $   #
#   $.#
# @   #
#. .$ #
#######
