########
#   $+.#
# *$   #
#   .$ #
#     .#
#      #
#     $#
#      #
########
