########
########
####*###
###*#*##
#.#.   #
#$ $   #
#@     #
########
