#########
#########
#**# ####
#### ##.#
#*##    #
####  $$#
#### . @#
#########
