#######
#@$.###
#$*####
#. ##.#
#  # $#
#     #
#######
