######
# @  #
#. $ #
#.$  #
######
