############
# $  .  . ##
#     $ @ ##
#       $ *#
#.   * $. ##
#       ####
############
