#########
##     .#
# $.$$ .#
#@     ##
#########
