#########
#       #
#*.  $. #
#@$     #
#*      #
#########
