###########
##      . #
##   $ $  #
##  .    .#
#. * $$ $ #
#       @.#
###########
