#######
#     #
#   $$#
#  $. #
# @ ..#
#######
