######
# @.##
# $* #
#    #
######
