###########
#      . ##
#$ $  $  *#
#.     $ .#
##    . $ #
#.   .    #
#*    @ $ #
##        #
###########
