###########
#       ###
# $  *    #
# @..  #$ #
# $.$$   ##
#  ..   ###
###########
