#########
#*  . $+#
#.    $$#
#       #
###     #
#########
