###########
#  @     ##
#     * $*#
# $.    .##
# $  $  ###
#  .  . ###
###########
