#########
#       #
# **.   #
# .#    #
# $$  $ #
#  @  . #
#########
