#########
#   .   #
# $  $. #
#@    * #
#    *  #
#   $  .#
#########
