############
###   #*.###
#*#$# *   ##
##. $ $  *@#
##   .  $  #
##* .#     #
##   #     #
##         #
############
