######
#    #
#. $ #
#@   #
#* $ #
#    #
#  . #
######
