##########
#.      ##
#    $ $*#
#       *#
#$    $.##
#. $ .  @#
#     .###
#      ###
##########
