#######
#@    #
#.$   #
# * . #
# $   #
#  .$ #
#   # #
#######
