#####
#####
#.###
#  .#
# .$#
#$$ #
#@  #
#####
