###########
#  .     ##
# $ .    ##
#     * ###
#    $$ .##
#.       ##
# $   $ ###
#.$@ .$ .##
###########
