########
####   #
###*.$ #
##.#   #
#.     #
#$$ $. #
#@     #
########
