#####
# * #
#@ .#
# $ #
#   #
#####
