#####
#   #
# * #
#@$ #
#.  #
#   #
#####
