#######
#   #.#
#   $ #
#   .@#
# $  $#
#.    #
#  .$$#
#   #.#
#######
