###########
#      .  #
# *#   $$@#
# $.  .   #
###########
