########
#*#. $@#
#####*$#
###### #
######.#
########
###*####
########
