##########
#        #
#$   $. *#
# @  *#  #
#.     . #
# *  $   #
#        #
##########
