########
#.  @$ #
#.   $ #
#      #
#*     #
#####  #
#*##*###
########
