###########
#    ##*###
#$   ###*##
#+$.#######
###########
