######
# $ .#
# $ .#
#    #
#    #
#    #
# .$@#
# .$ #
######
