########
#     @#
#    $ #
#    . #
# .##$ #
# $#  .#
# $. *##
#    ###
########
