######
##   #
#   .#
#  $$#
#   +#
######
