############
##   .     #
##   $     #
#.     .*  #
#$$    $.  #
#+$    ##  #
############
