######
#  @ #
#. $$#
#    #
# ##.#
# ##*#
#  ###
######
