#####
#  ##
#   #
#.  #
#$  #
#+$ #
#####
