############
# $ .     @#
# .     $ $#
# .$$.     #
#          #
#    .  $ .#
############
