######
####.#
###. #
#    #
# #$$#
#  . #
#  $*#
# @  #
######
