############
###.      @#
##   $ $$$ #
#   . *  . #
#     .    #
############
