########
#.     #
##   *$#
# $    #
#    $ #
#  .  .#
#   $  #
#  @  .#
########
