############
##   @  #  #
#**#$$ ##  #
####  .    #
#*##.      #
############
