##########
###*####*#
#######*##
#.*#######
# $.######
# ########
#$########
#@$.######
##########
