#######
#   @ #
# $   #
##.$. #
#######
