###########
# $    .+ #
#  *    $ #
#.   $    #
# $  .    #
###########
