########
#      #
# $ * .#
# @    #
# $.*  #
# #    #
########
