#########
#     @##
#   $$$.#
# . $  ##
#    ..##
#########
