#######
#     #
#   . #
#   $.#
# $   #
#$  $.#
#.  @ #
#######
