###########
#######   #
####     ##
#.#*.$ #. #
# ##   #  #
# $.   .$ #
#$      $ #
#@* $  .  #
###########
