#######
#.#####
#  ####
#$*####
#@$ .##
#######
