########
#      #
# *.$$*#
# #  .##
# $  .##
#      #
# @    #
#    ###
########
