#####
#####
#####
###.#
#.# #
#$*$#
#  @#
#####
