###########
#@$. $  ..#
#$$    $  #
#  . ##*  #
#.##      #
#    ######
########*##
###########
