#########
#       #
# $  $ $#
#  ..  +#
# * $.###
#      ##
#########
