############
#.   .  @  #
#$   $  $ $#
#       .  #
#          #
##* .$    .#
############
