########
#     ##
# $$$@*#
#     .#
# ...  #
#     $#
#      #
########
