######
# @  #
# $ $#
# . .#
######
