############
###       ##
#.#   $ .* #
#    .     #
#$      $$ #
#   .   .$@#
############
