#########
#    .  #
# $*.   #
# $  *  #
#       #
###  . .#
### $ $ #
###  @  #
#########
