##########
#@##..   #
#     $$ #
# $   $  #
##.#   . #
##########
