############
####### #  #
######.    #
######   $$#
###*  $.  .#
###. $@$ .##
############
