########
#      #
#*$ $  #
#  @.  #
# .    #
########
