############
#   .      #
# +  $$  . #
#  .$ .    #
#    $   $ #
# #   $    #
##..$      #
############
