#####
# *##
#.@##
# $ #
#   #
#  *#
#  ##
#####
