########
##.. $ #
###  $@#
##.  $ #
########
