######
# .###
#  # #
# $$.#
#   @#
######
