##########
#   .  $ #
#   .    #
#   $*.  #
#     $$ #
#   .    #
# $  .  @#
##########
