######
#. @ #
# $$$#
#.  .#
#    #
#    #
######
