#####
#*  #
## .#
#.$ #
#  @#
# $ #
#   #
#####
