#######
# @. .#
# $ $ #
#$ .  #
#   $ #
#.    #
#######
