############
####       #
#.#     $  #
# $  ..$   #
#$  .$ *@  #
#   #  *   #
#        #*#
##   .   *##
############
