#######
#.    #
# .   #
#   $ #
#$* $ #
#  @ .#
#######
