######
#  #.#
# @  #
# $  #
#. . #
#  $$#
#    #
######
