#######
#    ##
#$. $ #
#  .* #
#@  $ #
#.    #
#  .$ #
#     #
#######
