########
#      #
#   .$ #
#$     #
#.    *#
##.  $@#
########
