#########
# . .   #
# $$ *$ #
#     $@#
#   .   #
#    $  #
#    .. #
##      #
#########
