############
#        ###
#+$$$    *##
# $        #
# .     $  #
#      # ###
#*#..  #.###
############
