##########
#     .*@#
# $.   $ #
#   $ .  #
##########
