############
#       ##.#
#  .$$  .$$#
#   .@     #
############
