###########
#   ##.   #
# #   #   #
#  ##     #
#     $ $##
#   * .   #
#$$.$.   ##
#+$   .*###
###########
