############
#      .  ##
#   $ .$  ##
#   @$    .#
# .* $   $ #
#         .#
############
