###########
#       @ #
##**.  $$ #
##.       #
###########
