###########
###   . $+#
###    $$ #
####*    .#
###########
