############
#     .    #
#     $$   #
#       .  #
#.$ *   .$ #
#    @   * #
############
