###########
#  $...* ##
#  * $    #
#  @    $ #
#    $    #
#     .   #
###########
