############
#### $  .  #
####    $  #
## . $*. $ #
#     +$.  #
#          #
############
