############
#     .@   #
#  $  $  $$#
#  .   .# .#
############
