###########
###       #
#** .@$ $##
###     .*#
###       #
###########
