###########
#  .      #
# $ $@. $ #
#. .  $   #
###########
