###########
####*+$ .##
#####$$.  #
#####    *#
###########
###########
