#######
#     #
#$    #
#+*   #
#######
