########
###    #
##   * #
##   $.#
###    #
#.###. #
#$$ .$ #
#@     #
########
