###########
##    #####
#.$   #####
##.$.  ####
#      **##
# $      ##
#**       #
#@$  .    #
###########
