#########
#@$ .####
#$  $. ##
#.     ##
#########
