###########
##       .#
###   # # #
# @## #  ##
# # # # # #
#       # #
# $  #    #
#    #    #
###########