#####
#@  #
#*# #
#  *#
# # #
#$  #
#.# #
#####