#######
#.    #
#     #
#     #
# @ $ #
#     #
#######
