###########
#         #
#  . $    #
#  .#  *  #
# @       #
#   #     #
#   #$    #
#   #     #
###########
