#######
#     #
#     #
#  .  #
# @ $ #
#     #
#######
