#######
#     #
# @   #
# .   #
# .   #
#  $$ #
#######