 ###      
##+#######
#  ..    #
# $  $$  #
######   #
     #####
