######  
#    ###
#  $ $ #
# # $+ #
#   #..#
########
